<!--Saved by Quest 5.5.5328.26617-->
<asl version="550">
  <include ref="English.aslx" />
  <include ref="Core.aslx" />
  <template name="DefaultSelfDescription">You are wearing damp prisoner's robes. They are uncomfortable and cold.</template>
  <template name="DefaultHelp"><![CDATA[<u>Quick Help</u><br/>
<b>- Objects:</b> Try LOOK AT ..., TAKE ..., OPEN ..., USE ..., TALK<br/>
<b>- Facing:</b> Type FACE ... to face a direction<br/>
<b>- Moving around:</b> Type NORTH, EAST, SOUTH, WEST, UP or DOWN<br/>
<b>- Lantern:</b> Your lantern can be at three light levels: off, dim or bright. Higher levels give you more information, but burn more fuel per turn. Type TURN UP/DOWN LANTERN to change the light level. Type TURN OFF LANTERN, DIM LANTERN or TURN ON LANTERN to switch to off, dim or bright mode respectively<br/>
<b>- Heartbeat:</b> When the heartbeat counter in the top-right corner reaches zero, time will pass. Performing any action will reset the counter to 10.<br/>
<b>- Riddles:</b> Type REMEMBER to remember the last riddle you were given<br/>
<b>- Shortcuts:</b> Press the up arrow and down arrow to scroll through commands you have already typed in. Try X ... as a shortcut for LOOK AT..., N as a shortcut for NORTH, or FN as a shortcut for FACE NORTH<br/>          ]]></template>
  <game name="Shadowed">
    <gameid>245fb0e5-fd17-4ec8-ac17-5d4d0ec1d710</gameid>
    <version>1.0</version>
    <firstpublished>2014</firstpublished>
    <gridmap type="boolean">false</gridmap>
    <author>Team Cubed</author>
    <debug type="boolean">false</debug>
    <addable_fuel type="stringlist">
      <value>add10</value>
      <value>add20</value>
      <value>add30</value>
      <value>add60</value>
      <value>addlots</value>
    </addable_fuel>
    <autodescription />
    <showdescriptiononenter />
    <showlocation type="boolean">false</showlocation>
    <defaultfont>'Courier New', Courier, monospace</defaultfont>
    <defaultwebfont>Vollkorn</defaultwebfont>
    <defaultbackground>#101020</defaultbackground>
    <defaultforeground>White</defaultforeground>
    <underlinehyperlinks />
    <enablehyperlinks type="boolean">false</enablehyperlinks>
    <showtitle />
    <showhealth type="boolean">false</showhealth>
    <counterDisabled type="boolean">false</counterDisabled>
    <statusattributes type="stringdictionary" />
    <heartRate type="int">1200</heartRate>
    <heartEnabled type="boolean">false</heartEnabled>
    <defaultHeartRate type="int">1200</defaultHeartRate>
    <jumpScareAmount type="int">900</jumpScareAmount>
    <attr name="cask_size" type="int">20</attr>
    <part type="int">0</part>
    <reenableCount type="int">0</reenableCount>
    <saveTime type="boolean">false</saveTime>
    <helpShown type="boolean">false</helpShown>
    <geoffreyMode type="boolean">false</geoffreyMode>
    <geoffreyCount type="int">0</geoffreyCount>
    <fakeTurn type="boolean">false</fakeTurn>
    <heartCount>0</heartCount>
    <gameover type="boolean">false</gameover>
    <autodescription_youarein_useprefix />
    <attr name="autodescription_youcansee" type="int">0</attr>
    <attr name="autodescription_description" type="int">1</attr>
    <attr name="autodescription_youcango" type="int">2</attr>
    <attr name="autodescription_youarein" type="int">0</attr>
    <pov type="object">player</pov>
    <start type="script">
      // Initial player facing
      player.facing_num = 0
      dictionary remove (player.statusattributes, "facing")
      dictionary add (player.statusattributes, "facing", StringListItem(player.facings, player.facing_num))
      game.heartRate = game.defaultHeartRate
      LockHub
      msg ("You groan, and begin to open your eyes. Your vision is blurry at first, and you feel something wet on your face. You push yourself up on your hands and knees, and blink your eyes repeatedly to clear your vision. You see a face in front of you. It is your reflection in a puddle on the ground. You shake your head, and look down at your familiar face. It looks a little sunken in, and tired. You sigh, and stand up.")
      msg ("Once standing you notice a piece of paper in your hand. Confused, you uncrumple the paper and read the words with the help of the moonlight coming from the nearby window:")
      msg ("")
      PrintRiddle (0)
      msg ("")
      // REMOVE ME
      // game.part = 3
      // player.parent = nursery13
      // lantern.parent = player
      // lantern.light_level = 1
      // game.heartEnabled = true
    </start>
    <changedpart type="script">
      if (game.part = 3) {
        rook.visible = false
        knight.visible = false
        bishop.visible = false
        queen.visible = false
        pawn.visible = true
        king.visible = true
      }
      else {
        rook.visible = true
        knight.visible = true
        bishop.visible = true
        queen.visible = true
        pawn.visible = true
        king.visible = false
      }
    </changedpart>
  </game>
  <command name="help">
    <pattern type="string">^help$|^\?$</pattern>
    <script>
      msg (Template("DefaultHelp"))
      if (not game.helpShown) {
        game.helpShown = true
        DisableHeart
      }
    </script>
  </command>
  <command name="save">
    <pattern type="string">^save$</pattern>
    <script>
      request (RequestSave, "")
      if (game.saveTime) {
        DisableHeart
        game.saveTime = false
      }
    </script>
  </command>
  <command name="lookdir">
    <pattern type="string"><![CDATA[^look (?<exit>north|east|south|west|northeast|northwest|southeast|southwest|out|up|down|n|e|s|w|ne|nw|se|sw|o|u|d)$]]></pattern>
    <script><![CDATA[
      switch (exit.alias) {
        case ("north") {
          FaceNorth
          msg ("You turn to face north.")
          ShowRoomDescription
        }
        case ("n") {
          FaceNorth
          msg ("You turn to face north.")
          ShowRoomDescription
        }
        case ("south") {
          FaceSouth
          msg ("You turn to face south.")
          ShowRoomDescription
        }
        case ("s") {
          FaceSouth
          msg ("You turn to face south.")
          ShowRoomDescription
        }
        case ("west") {
          FaceSouth
          msg ("You turn to face west.")
          ShowRoomDescription
        }
        case ("w") {
          FaceSouth
          msg ("You turn to face west.")
          ShowRoomDescription
        }
        case ("east") {
          FaceSouth
          msg ("You turn to face east.")
          ShowRoomDescription
        }
        case ("e") {
          FaceSouth
          msg ("You turn to face east.")
          ShowRoomDescription
        }
        case (default) {
          if (HasScript(exit, "look")) {
            do (exit, "look")
          }
          else {
            message = DynamicTemplate("YouLooking",exit.alias)
            if (HasString(exit, "look")) {
              if (exit.look <> "") {
                message = exit.look
              }
            }
            if (exit.locked) {
              if (HasString(exit,"lockmessage")) {
                lockmessage = exit.lockmessage
              }
              else {
                lockmessage = Template("LockedExit")
              }
              msg (message+" "+lockmessage)
            }
            else {
              msg (message)
            }
          }
        }
      }
    ]]></script>
  </command>
  <verb>
    <property>turnup</property>
    <pattern>turn up</pattern>
    <defaultexpression>"You can't turn up " + object.article + "."</defaultexpression>
  </verb>
  <verb>
    <property>turndown</property>
    <pattern>turn down</pattern>
    <defaultexpression>"You can't turn down " + object.article + "."</defaultexpression>
  </verb>
  <object name="defaultroom">
    <inherit name="editor_room" />
    <usedefaultprefix />
    <descriptions type="stringdictionary">
      <item>
        <key>darknorth</key>
        <value>defaultdarknorth</value>
      </item>
      <item>
        <key>darkeast</key>
        <value>defaultdarkeast</value>
      </item>
      <item>
        <key>darksouth</key>
        <value>defaultdarksouth</value>
      </item>
      <item>
        <key>darkwest</key>
        <value>defaultdarkwest</value>
      </item>
      <item>
        <key>dimnorth</key>
        <value>defaultdimnorth</value>
      </item>
      <item>
        <key>dimeast</key>
        <value>defaultdimeast</value>
      </item>
      <item>
        <key>dimsouth</key>
        <value>defaultdimsouth</value>
      </item>
      <item>
        <key>dimwest</key>
        <value>defaultdimwest</value>
      </item>
      <item>
        <key>brightnorth</key>
        <value>defaultbrightnorth</value>
      </item>
      <item>
        <key>brighteast</key>
        <value>defaultbrighteast</value>
      </item>
      <item>
        <key>brightsouth</key>
        <value>defaultbrightsouth</value>
      </item>
      <item>
        <key>brightwest</key>
        <value>defaultbrightwest</value>
      </item>
    </descriptions>
    <description type="script">
      PrintRoomDesc (False)
    </description>
    <exit name="North" alias="north" to="defaultroom">
      <inherit name="northdirection" />
      <runscript />
      <script type="script">
        MoveAndFace (defaultroom, 0)
      </script>
    </exit>
    <exit name="East" alias="east" to="defaultroom">
      <inherit name="eastdirection" />
      <runscript />
      <script type="script">
        MoveAndFace (defaultroom, 1)
      </script>
    </exit>
    <exit name="South" alias="south" to="defaultroom">
      <inherit name="southdirection" />
      <runscript />
      <script type="script">
        MoveAndFace (defaultroom, 2)
      </script>
    </exit>
    <exit name="West" alias="west" to="defaultroom">
      <inherit name="westdirection" />
      <runscript />
      <visible />
      <script type="script">
        MoveAndFace (defaultroom, 3)
      </script>
    </exit>
  </object>
  <verb>
    <property>turnleft</property>
    <pattern>turn left</pattern>
    <defaultexpression>"You can't turn left " + object.article + "."</defaultexpression>
  </verb>
  <command name="Face North">
    <pattern type="string">(Face North|face n|f north|f n|fn)</pattern>
    <script><![CDATA[
      if (player.facing_num <> 0) {
        FaceNorth
        msg ("You turn to face north.")
        ShowRoomDescription
      }
      else {
        msg ("You are already facing north.")
      }
    ]]></script>
  </command>
  <command name="Face East">
    <pattern type="string">(Face East|face e|f east|f e|fe)</pattern>
    <script><![CDATA[
      if (player.facing_num <> 1) {
        FaceEast
        msg ("You turn to face east.")
        ShowRoomDescription
      }
      else {
        msg ("You are already facing east.")
      }
    ]]></script>
  </command>
  <command name="Face South">
    <pattern type="string">(face south|face s|f south|f s|fs)</pattern>
    <script><![CDATA[
      if (player.facing_num <> 2) {
        FaceSouth
        msg ("You turn to face south.")
        ShowRoomDescription
      }
      else {
        msg ("You are already facing south.")
      }
    ]]></script>
  </command>
  <command name="Face West">
    <pattern type="string">(face west|f west|face w|f w|fw)</pattern>
    <script><![CDATA[
      if (player.facing_num <> 3) {
        FaceWest
        msg ("You turn to face west.")
        ShowRoomDescription
      }
      else {
        msg ("You are already facing west.")
      }
    ]]></script>
  </command>
  <command name="debug">
    <pattern>debugme</pattern>
    <script>
      if (game.debug) {
        msg ("Debug off.")
        game.debug = False
      }
      else {
        msg ("Debug on.")
        game.debug = True
      }
    </script>
  </command>
  <command name="Add fuel">
    <pattern>morefuel</pattern>
    <script>
      if (game.debug) {
        ShowMenu ("How much?", game.addable_fuel, True) {
          msg (result)
          switch (result) {
            case ("add10") {
              lantern.fuel_level = lantern.fuel_level + 10
            }
            case ("add20") {
              lantern.fuel_level = lantern.fuel_level + 20
            }
            case ("add30") {
              lantern.fuel_level = lantern.fuel_level + 30
            }
            case ("add60") {
              lantern.fuel_level = lantern.fuel_level + 60
            }
            case ("addlots") {
              lantern.fuel_level = lantern.fuel_level + 99999
            }
            default {
              msg ("Not adding.")
            }
          }
        }
      }
      else {
        msg ("I don't understand your command.")
      }
    </script>
  </command>
  <object name="dungeon">
    <inherit name="editor_object" />
    <object name="dungeon1">
      <inherit name="editor_room" />
      <usedefaultprefix />
      <descriptions type="stringdictionary">
        <item>
          <key>darknorth</key>
          <value>You are on the staircase. You cannot see; it is pitch black. You feel a cord hanging directly in front of you.</value>
        </item>
        <item>
          <key>darkeast</key>
          <value>You are on the staircase. You cannot see; it is pitch black. You can feel a wall directly in front of you.</value>
        </item>
        <item>
          <key>darksouth</key>
          <value>You are on the staircase. You cannot see; it is pitch black.</value>
        </item>
        <item>
          <key>darkwest</key>
          <value>You are on the staircase. You cannot see; it is pitch black. You can feel a wall directly in front of you.</value>
        </item>
        <item>
          <key>dimnorth</key>
          <value>TODO: implement this description</value>
        </item>
        <item>
          <key>dimeast</key>
          <value>TODO: implement this description</value>
        </item>
        <item>
          <key>dimsouth</key>
          <value>TODO: implement this description</value>
        </item>
        <item>
          <key>dimwest</key>
          <value>TODO: implement this description</value>
        </item>
        <item>
          <key>brightnorth</key>
          <value>N/A </value>
        </item>
        <item>
          <key>brighteast</key>
          <value>N/A </value>
        </item>
        <item>
          <key>brightsouth</key>
          <value>N/A </value>
        </item>
        <item>
          <key>brightwest</key>
          <value>N/A </value>
        </item>
      </descriptions>
      <attr name="ladder_down" type="boolean">false</attr>
      <description type="script">
        PrintRoomDesc (False)
        if (dungeon1.ladder_down) {
          msg ("You can still feel the ladder that slid down earlier.")
        }
      </description>
      <exit name="South1" alias="south" to="defaultroom">
        <inherit name="southdirection" />
        <runscript />
        <script type="script">
          MoveAndFace (dungeon2, 2)
        </script>
      </exit>
      <exit name="NorthToHub" alias="north" to="defaultroom">
        <inherit name="northdirection" />
        <runscript />
        <visible type="boolean">false</visible>
        <script type="script">
          msg ("You climb up the ladder, which slides closed behind you as you reach the top. You close the trapdoor at the top so you don't fall back down.")
          dungeon1.ladder_down = False
          MoveAndFace (hub16, 0)
          MakeExitInvisible (UpToHub)
          MakeExitInvisible (NorthToHub)
        </script>
      </exit>
      <command name="Pull cord">
        <pattern type="string">pull (cord|rope|string)</pattern>
        <script>
          if (not dungeon1.ladder_down) {
            dungeon1.ladder_down = True
            msg ("As you pull the cord you hear a grinding noise with a final thump. Upon further inspection you feel that a ladder has slid down in front of you.")
            MakeExitVisible (NorthToHub)
            MakeExitVisible (UpToHub)
          }
          else {
            msg ("You pull the cord again but nothing happens.")
          }
        </script>
      </command>
      <exit name="UpToHub" alias="up" to="defaultroom">
        <inherit name="updirection" />
        <runscript />
        <visible type="boolean">false</visible>
        <script type="script">
          msg ("You climb up the ladder, which slides closed behind you as you reach the top. You close the trapdoor at the top so you don't fall back down.")
          dungeon1.ladder_down = False
          MoveAndFace (hub16, 0)
          MakeExitInvisible (UpToHub)
          MakeExitInvisible (NorthToHub)
        </script>
      </exit>
      <command name="Climb Ladder">
        <pattern type="string">(climb|up) ladder</pattern>
        <unresolved type="string"></unresolved>
        <script>
          // Alternate way to take the exit, because seriously my first instinct is to "climb" not up/north
          msg ("You climb up the ladder, which slides closed behind you as you reach the top. You close the trapdoor at the top so you don't fall back down.")
          dungeon1.ladder_down = False
          MoveAndFace (hub16, 0)
          MakeExitInvisible (UpToHub)
          MakeExitInvisible (NorthToHub)
        </script>
      </command>
    </object>
    <object name="dungeon2">
      <inherit name="editor_room" />
      <usedefaultprefix />
      <descriptions type="stringdictionary">
        <item>
          <key>darknorth</key>
          <value>You are on the staircase. You cannot see.</value>
        </item>
        <item>
          <key>darkeast</key>
          <value>You are on the staircase. You cannot see. You can feel a wall directly in front of you.</value>
        </item>
        <item>
          <key>darksouth</key>
          <value>You are on the staircase. You cannot see.</value>
        </item>
        <item>
          <key>darkwest</key>
          <value>You are on the staircase. You cannot see. You can feel a wall in front of you.</value>
        </item>
        <item>
          <key>dimnorth</key>
          <value>TODO: implement this description</value>
        </item>
        <item>
          <key>dimeast</key>
          <value>TODO: implement this description</value>
        </item>
        <item>
          <key>dimsouth</key>
          <value>TODO: implement this description</value>
        </item>
        <item>
          <key>dimwest</key>
          <value>TODO: implement this description</value>
        </item>
        <item>
          <key>brightnorth</key>
          <value>N/A </value>
        </item>
        <item>
          <key>brighteast</key>
          <value>N/A </value>
        </item>
        <item>
          <key>brightsouth</key>
          <value>N/A </value>
        </item>
        <item>
          <key>brightwest</key>
          <value>N/A </value>
        </item>
      </descriptions>
      <description type="script">
        PrintRoomDesc (False)
      </description>
      <exit name="North2" alias="north" to="defaultroom">
        <inherit name="northdirection" />
        <runscript />
        <script type="script">
          MoveAndFace (dungeon1, 0)
        </script>
      </exit>
      <exit name="South2" alias="south" to="defaultroom">
        <inherit name="southdirection" />
        <runscript />
        <script type="script">
          MoveAndFace (dungeon5, 2)
        </script>
      </exit>
    </object>
    <object name="dungeon3">
      <inherit name="editor_room" />
      <usedefaultprefix />
      <descriptions type="stringdictionary">
        <item>
          <key>darknorth</key>
          <value>You can see out of the window, moonlight is shining in. Outside the window is a steep cliff, with jagged rocks, and crashing waves at the bottom. You would not survive the fall. </value>
        </item>
        <item>
          <key>darkeast</key>
          <value>You are in a prison cell. You can see a wall a couple of steps in front of you. There is a window to the north of you.</value>
        </item>
        <item>
          <key>darksouth</key>
          <value>You are in a prison cell. You see a puddle on the floor in front of you. There is a chair to the west of you. The cell door is a few steps south of you.</value>
        </item>
        <item>
          <key>darkwest</key>
          <value>You are in a prison cell. You see a chair in front of you, there is nothing of interest on it.</value>
        </item>
        <item>
          <key>dimnorth</key>
          <value>TODO: implement this description</value>
        </item>
        <item>
          <key>dimeast</key>
          <value>TODO: implement this description</value>
        </item>
        <item>
          <key>dimsouth</key>
          <value>TODO: implement this description</value>
        </item>
        <item>
          <key>dimwest</key>
          <value>TODO: implement this description</value>
        </item>
        <item>
          <key>brightnorth</key>
          <value>N/A </value>
        </item>
        <item>
          <key>brighteast</key>
          <value>N/A </value>
        </item>
        <item>
          <key>brightsouth</key>
          <value>N/A </value>
        </item>
        <item>
          <key>brightwest</key>
          <value>N/A </value>
        </item>
      </descriptions>
      <description type="script"><![CDATA[
        if (player.facing_num = 0 and game.part >= 3) {
          msg ("There is a window in front of you, it is boarded over, but a few rays of sunlight are sneaking in through the cracks, lighting up the area.")
        }
        else {
          PrintRoomDesc (False)
        }
      ]]></description>
      <exit name="East3" alias="east" to="defaultroom">
        <inherit name="eastdirection" />
        <runscript />
        <script type="script">
          MoveAndFace (dungeon4, 1)
        </script>
      </exit>
      <exit name="South3" alias="south" to="defaultroom">
        <inherit name="southdirection" />
        <runscript />
        <script type="script">
          MoveAndFace (dungeon7, 2)
        </script>
      </exit>
    </object>
    <object name="dungeon4">
      <inherit name="editor_room" />
      <usedefaultprefix />
      <descriptions type="stringdictionary">
        <item>
          <key>darknorth</key>
          <value>You are in a prison cell. There is a wall in front of you. You are in a corner of the cell. </value>
        </item>
        <item>
          <key>darkeast</key>
          <value>You are in a prison cell. There is a wall in front of you. You are in a corner of the cell.</value>
        </item>
        <item>
          <key>darksouth</key>
          <value>You are in a prison cell. You can see the cell bars a few steps in front of you.</value>
        </item>
        <item>
          <key>darkwest</key>
          <value>You are in a prison cell. You can see most of the cell from here. The chair in the northwest corner, the puddle in the middle of the cell, cell bars, and door to the south side of the cell. </value>
        </item>
        <item>
          <key>dimnorth</key>
          <value>TODO: implement this description</value>
        </item>
        <item>
          <key>dimeast</key>
          <value>TODO: implement this description</value>
        </item>
        <item>
          <key>dimsouth</key>
          <value>TODO: implement this description</value>
        </item>
        <item>
          <key>dimwest</key>
          <value>TODO: implement this description</value>
        </item>
        <item>
          <key>brightnorth</key>
          <value>N/A </value>
        </item>
        <item>
          <key>brighteast</key>
          <value>N/A </value>
        </item>
        <item>
          <key>brightsouth</key>
          <value>N/A </value>
        </item>
        <item>
          <key>brightwest</key>
          <value>N/A </value>
        </item>
      </descriptions>
      <description type="script">
        PrintRoomDesc (False)
      </description>
      <exit name="South4" alias="south" to="defaultroom">
        <inherit name="southdirection" />
        <runscript />
        <script type="script">
          MoveAndFace (dungeon8, 2)
        </script>
      </exit>
      <exit name="West4" alias="west" to="defaultroom">
        <inherit name="westdirection" />
        <runscript />
        <visible />
        <script type="script">
          MoveAndFace (dungeon3, 3)
        </script>
      </exit>
    </object>
    <object name="dungeon5">
      <inherit name="editor_room" />
      <usedefaultprefix />
      <descriptions type="stringdictionary">
        <item>
          <key>darknorth</key>
          <value>You are on the staircase. You can barely see. It is very dark, the light cannot illuminate this area. </value>
        </item>
        <item>
          <key>darkeast</key>
          <value>You are on the staircase. You can barely see. It is very dark. You are facing a wall.</value>
        </item>
        <item>
          <key>darksouth</key>
          <value>You are on the staircase. You can barely see. It is very dark. </value>
        </item>
        <item>
          <key>darkwest</key>
          <value>You are on the staircase. You can barely see. It is very dark. You are facing a wall.</value>
        </item>
        <item>
          <key>dimnorth</key>
          <value>TODO: implement this description</value>
        </item>
        <item>
          <key>dimeast</key>
          <value>TODO: implement this description</value>
        </item>
        <item>
          <key>dimsouth</key>
          <value>TODO: implement this description</value>
        </item>
        <item>
          <key>dimwest</key>
          <value>TODO: implement this description</value>
        </item>
        <item>
          <key>brightnorth</key>
          <value>N/A   </value>
        </item>
        <item>
          <key>brighteast</key>
          <value>N/A </value>
        </item>
        <item>
          <key>brightsouth</key>
          <value>N/A </value>
        </item>
        <item>
          <key>brightwest</key>
          <value>N/A </value>
        </item>
      </descriptions>
      <description type="script">
        PrintRoomDesc (False)
      </description>
      <exit name="North5" alias="north" to="defaultroom">
        <inherit name="northdirection" />
        <runscript />
        <script type="script">
          MoveAndFace (dungeon2, 0)
        </script>
      </exit>
      <exit name="South5" alias="south" to="defaultroom">
        <inherit name="southdirection" />
        <runscript />
        <script type="script">
          MoveAndFace (dungeon9, 2)
        </script>
      </exit>
    </object>
    <object name="dungeon6">
      <inherit name="editor_room" />
      <usedefaultprefix />
      <descriptions type="stringdictionary">
        <item>
          <key>darknorth</key>
          <value>You are in a prison cell. You are facing a chair, there is nothing of interest on it.</value>
        </item>
        <item>
          <key>darkeast</key>
          <value>You are in a prison cell. There is a puddle on the floor in front of you. </value>
        </item>
        <item>
          <key>darksouth</key>
          <value>You are in a prison cell. You see the cell bars a few steps in front of you.</value>
        </item>
        <item>
          <key>darkwest</key>
          <value>You are in a prison cell. You are facing a wall. </value>
        </item>
        <item>
          <key>dimnorth</key>
          <value>TODO: implement this description</value>
        </item>
        <item>
          <key>dimeast</key>
          <value>TODO: implement this description</value>
        </item>
        <item>
          <key>dimsouth</key>
          <value>TODO: implement this description</value>
        </item>
        <item>
          <key>dimwest</key>
          <value>TODO: implement this description</value>
        </item>
        <item>
          <key>brightnorth</key>
          <value>N/A  N/A</value>
        </item>
        <item>
          <key>brighteast</key>
          <value>N/A </value>
        </item>
        <item>
          <key>brightsouth</key>
          <value>N/A </value>
        </item>
        <item>
          <key>brightwest</key>
          <value>N/A </value>
        </item>
      </descriptions>
      <description type="script">
        PrintRoomDesc (False)
      </description>
      <exit name="East6" alias="east" to="defaultroom">
        <inherit name="eastdirection" />
        <runscript />
        <script type="script">
          MoveAndFace (dungeon7, 1)
        </script>
      </exit>
      <exit name="South6" alias="south" to="defaultroom">
        <inherit name="southdirection" />
        <runscript />
        <script type="script">
          MoveAndFace (dungeon10, 2)
        </script>
      </exit>
    </object>
    <object name="dungeon7">
      <inherit name="editor_room" />
      <usedefaultprefix />
      <descriptions type="stringdictionary">
        <item>
          <key>darknorth</key>
          <value>You are in a prison cell. You are standing in a shallow puddle. You can see your reflection. </value>
        </item>
        <item>
          <key>darkeast</key>
          <value>You are in a prison cell. You are standing in a shallow puddle. You can see your reflection.</value>
        </item>
        <item>
          <key>darksouth</key>
          <value>You are in a prison cell. You are standing in a shallow puddle. You can see your reflection. You can see the cell door a few steps in front of you.</value>
        </item>
        <item>
          <key>darkwest</key>
          <value>You are in a prison cell. You are standing in a shallow puddle. You can see your reflection.</value>
        </item>
        <item>
          <key>dimnorth</key>
          <value>TODO: implement this description</value>
        </item>
        <item>
          <key>dimeast</key>
          <value>TODO: implement this description</value>
        </item>
        <item>
          <key>dimsouth</key>
          <value>TODO: implement this description</value>
        </item>
        <item>
          <key>dimwest</key>
          <value>TODO: implement this description</value>
        </item>
        <item>
          <key>brightnorth</key>
          <value>N/A </value>
        </item>
        <item>
          <key>brighteast</key>
          <value>N/A </value>
        </item>
        <item>
          <key>brightsouth</key>
          <value>N/A </value>
        </item>
        <item>
          <key>brightwest</key>
          <value>N/A </value>
        </item>
      </descriptions>
      <description type="script">
        PrintRoomDesc (False)
      </description>
      <enter type="script">
        LockHub
      </enter>
      <onexit type="script">
      </onexit>
      <firstenter type="script">
      </firstenter>
      <exit name="North7" alias="north" to="defaultroom">
        <inherit name="northdirection" />
        <runscript />
        <script type="script">
          MoveAndFace (dungeon3, 0)
        </script>
      </exit>
      <exit name="East7" alias="east" to="defaultroom">
        <inherit name="eastdirection" />
        <runscript />
        <script type="script">
          MoveAndFace (dungeon8, 1)
        </script>
      </exit>
      <exit name="South7" alias="south" to="defaultroom">
        <inherit name="southdirection" />
        <runscript />
        <script type="script">
          MoveAndFace (dungeon11, 2)
        </script>
      </exit>
      <exit name="West7" alias="west" to="defaultroom">
        <inherit name="westdirection" />
        <runscript />
        <visible />
        <script type="script">
          MoveAndFace (dungeon6, 3)
        </script>
      </exit>
      <object name="player">
        <inherit name="editor_object" />
        <inherit name="editor_player" />
        <facings type="stringlist">
          <value>Facing: north</value>
          <value>Facing: east</value>
          <value>Facing: south</value>
          <value>Facing: west</value>
        </facings>
        <statusattributes type="stringdictionary">
          <item>
            <key>facing</key>
            <value></value>
          </item>
        </statusattributes>
        <attr name="facing_num" type="int">0</attr>
        <lastPos type="object">dungeon7</lastPos>
        <facenorth type="script">
          player.facing_num = 0
          dictionary add (player.statusattributes, facing, StringListItem(player.facings, player.facing_num))
        </facenorth>
      </object>
    </object>
    <object name="dungeon8">
      <inherit name="editor_room" />
      <usedefaultprefix />
      <descriptions type="stringdictionary">
        <item>
          <key>darknorth</key>
          <value>You are in a prison cell. You can see moonlight streaming through a window a few steps northwest of you.</value>
        </item>
        <item>
          <key>darkeast</key>
          <value>You are in a prison cell. You are facing a wall.</value>
        </item>
        <item>
          <key>darksouth</key>
          <value>You are in a prison cell. You see the cell bars a couple steps in front of you.</value>
        </item>
        <item>
          <key>darkwest</key>
          <value>You are in a prison cell. There is a puddle on the floor in front of you.</value>
        </item>
        <item>
          <key>dimnorth</key>
          <value>TODO: implement this description</value>
        </item>
        <item>
          <key>dimeast</key>
          <value>TODO: implement this description</value>
        </item>
        <item>
          <key>dimsouth</key>
          <value>TODO: implement this description</value>
        </item>
        <item>
          <key>dimwest</key>
          <value>TODO: implement this description</value>
        </item>
        <item>
          <key>brightnorth</key>
          <value>N/A </value>
        </item>
        <item>
          <key>brighteast</key>
          <value>N/A </value>
        </item>
        <item>
          <key>brightsouth</key>
          <value>N/A </value>
        </item>
        <item>
          <key>brightwest</key>
          <value>N/A </value>
        </item>
      </descriptions>
      <description type="script"><![CDATA[
        if (player.facing_num = 0 and game.part >= 3) {
          msg ("You are in a prison cell. A few steps northwest of you there is a window, it is boarded up, but a few rays of sunlight are peaking through illuminating the area.")
        }
        else {
          PrintRoomDesc (False)
        }
      ]]></description>
      <exit name="West1" alias="west" to="defaultroom">
        <inherit name="westdirection" />
        <runscript />
        <visible />
        <script type="script">
          MoveAndFace (dungeon7, 3)
        </script>
      </exit>
      <exit name="South8" alias="south" to="defaultroom">
        <inherit name="southdirection" />
        <runscript />
        <script type="script">
          MoveAndFace (dungeon12, 2)
        </script>
      </exit>
      <exit name="North1" alias="north" to="defaultroom">
        <inherit name="northdirection" />
        <runscript />
        <script type="script">
          MoveAndFace (dungeon4, 0)
        </script>
      </exit>
    </object>
    <object name="dungeon9">
      <inherit name="editor_room" />
      <usedefaultprefix />
      <descriptions type="stringdictionary">
        <item>
          <key>darknorth</key>
          <value>You are on the staircase. You can barely see; the staircase seems to continue. </value>
        </item>
        <item>
          <key>darkeast</key>
          <value>You are on the staircase. You can barely see. You are facing a wall.</value>
        </item>
        <item>
          <key>darksouth</key>
          <value>You are on the staircase. You can barely see; the staircase seems to continue.</value>
        </item>
        <item>
          <key>darkwest</key>
          <value>You are on the staircase. You can barely see. You are facing a wall.</value>
        </item>
        <item>
          <key>dimnorth</key>
          <value>TODO: implement this description</value>
        </item>
        <item>
          <key>dimeast</key>
          <value>TODO: implement this description</value>
        </item>
        <item>
          <key>dimsouth</key>
          <value>TODO: implement this description</value>
        </item>
        <item>
          <key>dimwest</key>
          <value>TODO: implement this description</value>
        </item>
        <item>
          <key>brightnorth</key>
          <value>N/A </value>
        </item>
        <item>
          <key>brighteast</key>
          <value>N/A </value>
        </item>
        <item>
          <key>brightsouth</key>
          <value>N/A </value>
        </item>
        <item>
          <key>brightwest</key>
          <value>N/A </value>
        </item>
      </descriptions>
      <description type="script">
        PrintRoomDesc (False)
      </description>
      <exit name="South9" alias="south" to="defaultroom">
        <inherit name="southdirection" />
        <runscript />
        <script type="script">
          MoveAndFace (dungeon13, 2)
        </script>
      </exit>
      <exit name="North3" alias="north" to="defaultroom">
        <inherit name="northdirection" />
        <runscript />
        <script type="script">
          MoveAndFace (dungeon5, 0)
        </script>
      </exit>
    </object>
    <object name="dungeon10">
      <inherit name="editor_room" />
      <usedefaultprefix />
      <descriptions type="stringdictionary">
        <item>
          <key>darknorth</key>
          <value>You are in a prison cell. You can see most of the cell here. The chair, and window to the north; also, the puddle in the middle of the room.</value>
        </item>
        <item>
          <key>darkeast</key>
          <value>You are in a prison cell. </value>
        </item>
        <item>
          <key>darksouth</key>
          <value>You are in a prison cell. The cell bars are immediately in front of you.</value>
        </item>
        <item>
          <key>darkwest</key>
          <value>You are in a prison cell. You are facing a wall.</value>
        </item>
        <item>
          <key>dimnorth</key>
          <value>TODO: implement this description</value>
        </item>
        <item>
          <key>dimeast</key>
          <value>TODO: implement this description</value>
        </item>
        <item>
          <key>dimsouth</key>
          <value>TODO: implement this description</value>
        </item>
        <item>
          <key>dimwest</key>
          <value>TODO: implement this description</value>
        </item>
        <item>
          <key>brightnorth</key>
          <value>N/A </value>
        </item>
        <item>
          <key>brighteast</key>
          <value>N/A </value>
        </item>
        <item>
          <key>brightsouth</key>
          <value>N/A </value>
        </item>
        <item>
          <key>brightwest</key>
          <value>N/A </value>
        </item>
      </descriptions>
      <description type="script">
        PrintRoomDesc (False)
      </description>
      <exit name="East4" alias="east" to="defaultroom">
        <inherit name="eastdirection" />
        <runscript />
        <script type="script">
          MoveAndFace (dungeon11, 1)
        </script>
      </exit>
      <exit name="North4" alias="north" to="defaultroom">
        <inherit name="northdirection" />
        <runscript />
        <script type="script">
          MoveAndFace (dungeon6, 0)
        </script>
      </exit>
    </object>
    <object name="dungeon11">
      <inherit name="editor_room" />
      <usedefaultprefix />
      <descriptions type="stringdictionary">
        <item>
          <key>darknorth</key>
          <value>You are in a prison cell. The puddle is in front of you, and the window a couple steps in front of you.</value>
        </item>
        <item>
          <key>darkeast</key>
          <value>You are in a prison cell. There is a wall a few steps in front of you, and the cell door to the south of you.</value>
        </item>
        <item>
          <key>darksouth</key>
          <value>You are in a prison cell. The cell door is directly in front of you, it is open. You see a table beyond the door.</value>
        </item>
        <item>
          <key>darkwest</key>
          <value>You are in a prison cell. There is a wall a few steps in front of you.</value>
        </item>
        <item>
          <key>dimnorth</key>
          <value>TODO: implement this description</value>
        </item>
        <item>
          <key>dimeast</key>
          <value>TODO: implement this description</value>
        </item>
        <item>
          <key>dimsouth</key>
          <value>TODO: implement this description</value>
        </item>
        <item>
          <key>dimwest</key>
          <value>TODO: implement this description</value>
        </item>
        <item>
          <key>brightnorth</key>
          <value>N/A </value>
        </item>
        <item>
          <key>brighteast</key>
          <value>N/A </value>
        </item>
        <item>
          <key>brightsouth</key>
          <value>N/A </value>
        </item>
        <item>
          <key>brightwest</key>
          <value>N/A </value>
        </item>
      </descriptions>
      <description type="script">
        PrintRoomDesc (False)
      </description>
      <exit name="West5" alias="west" to="defaultroom">
        <inherit name="westdirection" />
        <runscript />
        <visible />
        <script type="script">
          MoveAndFace (dungeon10, 3)
        </script>
      </exit>
      <exit name="South11" alias="south" to="defaultroom">
        <inherit name="southdirection" />
        <runscript />
        <script type="script">
          MoveAndFace (dungeon15, 2)
        </script>
      </exit>
      <exit name="East5" alias="east" to="defaultroom">
        <inherit name="eastdirection" />
        <runscript />
        <script type="script">
          MoveAndFace (dungeon12, 1)
        </script>
      </exit>
      <exit name="North6" alias="north" to="defaultroom">
        <inherit name="northdirection" />
        <runscript />
        <script type="script">
          MoveAndFace (dungeon7, 0)
        </script>
      </exit>
    </object>
    <object name="dungeon12">
      <inherit name="editor_room" />
      <usedefaultprefix />
      <descriptions type="stringdictionary">
        <item>
          <key>darknorth</key>
          <value>You are in a prison cell. You can see the window, and chair northwest of you, and the puddle in the middle of the cell.</value>
        </item>
        <item>
          <key>darkeast</key>
          <value>You are in a prison cell. You are facing a wall.</value>
        </item>
        <item>
          <key>darksouth</key>
          <value>You are in a prison cell. You are facing the cell bars.</value>
        </item>
        <item>
          <key>darkwest</key>
          <value>You are in a prison cell. </value>
        </item>
        <item>
          <key>dimnorth</key>
          <value>TODO: implement this description</value>
        </item>
        <item>
          <key>dimeast</key>
          <value>TODO: implement this description</value>
        </item>
        <item>
          <key>dimsouth</key>
          <value>TODO: implement this description</value>
        </item>
        <item>
          <key>dimwest</key>
          <value>TODO: implement this description</value>
        </item>
        <item>
          <key>brightnorth</key>
          <value>N/A </value>
        </item>
        <item>
          <key>brighteast</key>
          <value>N/A </value>
        </item>
        <item>
          <key>brightsouth</key>
          <value>N/A </value>
        </item>
        <item>
          <key>brightwest</key>
          <value>N/A </value>
        </item>
      </descriptions>
      <description type="script">
        PrintRoomDesc (False)
      </description>
      <exit name="West6" alias="west" to="defaultroom">
        <inherit name="westdirection" />
        <runscript />
        <visible />
        <script type="script">
          MoveAndFace (dungeon11, 3)
        </script>
      </exit>
      <exit name="North8" alias="north" to="defaultroom">
        <inherit name="northdirection" />
        <runscript />
        <script type="script">
          MoveAndFace (dungeon8, 0)
        </script>
      </exit>
    </object>
    <object name="dungeon13">
      <inherit name="editor_room" />
      <usedefaultprefix />
      <descriptions type="stringdictionary">
        <item>
          <key>darknorth</key>
          <value>You are on a staircase. You can barely see; the staircase seems to continue upwards.</value>
        </item>
        <item>
          <key>darkeast</key>
          <value>You are on a staircase. You can barely see. You are facing a wall.</value>
        </item>
        <item>
          <key>darksouth</key>
          <value>You are on a staircase. You can barely see; the staircase ends in front of you.</value>
        </item>
        <item>
          <key>darkwest</key>
          <value>You are on a staircase. You can barely see. You are facing a wall.</value>
        </item>
        <item>
          <key>dimnorth</key>
          <value>TODO: implement this description</value>
        </item>
        <item>
          <key>dimeast</key>
          <value>TODO: implement this description</value>
        </item>
        <item>
          <key>dimsouth</key>
          <value>TODO: implement this description</value>
        </item>
        <item>
          <key>dimwest</key>
          <value>TODO: implement this description</value>
        </item>
        <item>
          <key>brightnorth</key>
          <value>N/A </value>
        </item>
        <item>
          <key>brighteast</key>
          <value>N/A </value>
        </item>
        <item>
          <key>brightsouth</key>
          <value>N/A </value>
        </item>
        <item>
          <key>brightwest</key>
          <value>N/A </value>
        </item>
      </descriptions>
      <description type="script">
        PrintRoomDesc (False)
      </description>
      <exit name="South13" alias="south" to="defaultroom">
        <inherit name="southdirection" />
        <runscript />
        <script type="script">
          MoveAndFace (dungeon21, 2)
        </script>
      </exit>
      <exit name="North9" alias="north" to="defaultroom">
        <inherit name="northdirection" />
        <runscript />
        <script type="script">
          MoveAndFace (dungeon9, 0)
        </script>
      </exit>
    </object>
    <object name="dungeon14">
      <inherit name="editor_room" />
      <usedefaultprefix />
      <descriptions type="stringdictionary">
        <item>
          <key>darknorth</key>
          <value>You are in the dungeon hallway. You are facing the prison cell bars.</value>
        </item>
        <item>
          <key>darkeast</key>
          <value>You are in the dungeon hallway. There is a table to the south of you.</value>
        </item>
        <item>
          <key>darksouth</key>
          <value>You are in the dungeon hallway. You are facing a table. </value>
        </item>
        <item>
          <key>darkwest</key>
          <value>You are in the dungeon hallway. You are facing a wall.</value>
        </item>
        <item>
          <key>dimnorth</key>
          <value>TODO: implement this description</value>
        </item>
        <item>
          <key>dimeast</key>
          <value>TODO: implement this description</value>
        </item>
        <item>
          <key>dimsouth</key>
          <value>TODO: implement this description</value>
        </item>
        <item>
          <key>dimwest</key>
          <value>TODO: implement this description</value>
        </item>
        <item>
          <key>brightnorth</key>
          <value>N/A </value>
        </item>
        <item>
          <key>brighteast</key>
          <value>N/A </value>
        </item>
        <item>
          <key>brightsouth</key>
          <value>N/A </value>
        </item>
        <item>
          <key>brightwest</key>
          <value>N/A </value>
        </item>
      </descriptions>
      <description type="script">
        PrintRoomDesc (False)
      </description>
      <exit name="East10" alias="east" to="defaultroom">
        <inherit name="eastdirection" />
        <runscript />
        <script type="script">
          MoveAndFace (dungeon15, 1)
        </script>
      </exit>
    </object>
    <object name="dungeon15">
      <inherit name="editor_room" />
      <usedefaultprefix />
      <descriptions type="stringdictionary">
        <item>
          <key>darknorth</key>
          <value>You are in the dungeon hallway. You see the open prison cell door in front of you. </value>
        </item>
        <item>
          <key>darkeast</key>
          <value>You are in the dungeon hallway. There is a table directly to the south of you.</value>
        </item>
        <item>
          <key>darksouth</key>
          <value>You are in the dungeon hallway. You are facing a table.</value>
        </item>
        <item>
          <key>darkwest</key>
          <value>You are in the dungeon hallway. There is a table directly south of you, and there is a wall a few steps in front of you.</value>
        </item>
        <item>
          <key>dimnorth</key>
          <value>TODO: implement this description</value>
        </item>
        <item>
          <key>dimeast</key>
          <value>TODO: implement this description</value>
        </item>
        <item>
          <key>dimsouth</key>
          <value>TODO: implement this description</value>
        </item>
        <item>
          <key>dimwest</key>
          <value>TODO: implement this description</value>
        </item>
        <item>
          <key>brightnorth</key>
          <value>N/A </value>
        </item>
        <item>
          <key>brighteast</key>
          <value>N/A </value>
        </item>
        <item>
          <key>brightsouth</key>
          <value>N/A </value>
        </item>
        <item>
          <key>brightwest</key>
          <value>N/A </value>
        </item>
      </descriptions>
      <description type="script">
        PrintRoomDesc (False)
      </description>
      <exit name="West10" alias="west" to="defaultroom">
        <inherit name="westdirection" />
        <runscript />
        <visible />
        <script type="script">
          MoveAndFace (dungeon14, 3)
        </script>
      </exit>
      <exit name="East11" alias="east" to="defaultroom">
        <inherit name="eastdirection" />
        <runscript />
        <script type="script">
          MoveAndFace (dungeon16, 1)
        </script>
      </exit>
      <exit name="North11" alias="north" to="defaultroom">
        <inherit name="northdirection" />
        <runscript />
        <script type="script">
          MoveAndFace (dungeon11, 0)
        </script>
      </exit>
    </object>
    <object name="dungeon16">
      <inherit name="editor_room" />
      <usedefaultprefix />
      <descriptions type="stringdictionary">
        <item>
          <key>darknorth</key>
          <value>You are in the dungeon hallway. You are facing the prison cell bars. </value>
        </item>
        <item>
          <key>darkeast</key>
          <value>You are in the dungeon hallway. </value>
        </item>
        <item>
          <key>darksouth</key>
          <value>You are in the dungeon hallway. There is a wall a few steps in front of you.</value>
        </item>
        <item>
          <key>darkwest</key>
          <value>You are in the dungeon hallway. There is a table a few steps to the southwest of you.</value>
        </item>
        <item>
          <key>dimnorth</key>
          <value>TODO: implement this description</value>
        </item>
        <item>
          <key>dimeast</key>
          <value>TODO: implement this description</value>
        </item>
        <item>
          <key>dimsouth</key>
          <value>TODO: implement this description</value>
        </item>
        <item>
          <key>dimwest</key>
          <value>TODO: implement this description</value>
        </item>
        <item>
          <key>brightnorth</key>
          <value>N/A </value>
        </item>
        <item>
          <key>brighteast</key>
          <value>N/A </value>
        </item>
        <item>
          <key>brightsouth</key>
          <value>N/A </value>
        </item>
        <item>
          <key>brightwest</key>
          <value>N/A </value>
        </item>
      </descriptions>
      <description type="script">
        PrintRoomDesc (False)
      </description>
      <exit name="West11" alias="west" to="defaultroom">
        <inherit name="westdirection" />
        <runscript />
        <visible />
        <script type="script">
          MoveAndFace (dungeon15, 3)
        </script>
      </exit>
      <exit name="South16" alias="south" to="defaultroom">
        <inherit name="southdirection" />
        <runscript />
        <script type="script">
          MoveAndFace (dungeon22, 2)
        </script>
      </exit>
      <exit name="East12" alias="east" to="defaultroom">
        <inherit name="eastdirection" />
        <runscript />
        <script type="script">
          MoveAndFace (dungeon17, 1)
        </script>
      </exit>
    </object>
    <object name="dungeon17">
      <inherit name="editor_room" />
      <usedefaultprefix />
      <descriptions type="stringdictionary">
        <item>
          <key>darknorth</key>
          <value>You are in the dungeon hallway. It is hard to see, you are facing cell bars to another prison cell. There appears to be lump in the corner of the cell, wrapped in burlap. You can see a bone sticking out of the burlap sack. </value>
        </item>
        <item>
          <key>darkeast</key>
          <value>You are in the dungeon hallway. It is hard to see.</value>
        </item>
        <item>
          <key>darksouth</key>
          <value>You are in the dungeon hallway. It is hard to see. </value>
        </item>
        <item>
          <key>darkwest</key>
          <value>You are in the dungeon hallway. It is hard to see.</value>
        </item>
        <item>
          <key>dimnorth</key>
          <value>TODO: implement this description</value>
        </item>
        <item>
          <key>dimeast</key>
          <value>TODO: implement this description</value>
        </item>
        <item>
          <key>dimsouth</key>
          <value>TODO: implement this description</value>
        </item>
        <item>
          <key>dimwest</key>
          <value>TODO: implement this description</value>
        </item>
        <item>
          <key>brightnorth</key>
          <value>N/A </value>
        </item>
        <item>
          <key>brighteast</key>
          <value>N/A </value>
        </item>
        <item>
          <key>brightsouth</key>
          <value>N/A </value>
        </item>
        <item>
          <key>brightwest</key>
          <value>N/A </value>
        </item>
      </descriptions>
      <description type="script">
        PrintRoomDesc (False)
      </description>
      <exit name="West12" alias="west" to="defaultroom">
        <inherit name="westdirection" />
        <runscript />
        <visible />
        <script type="script">
          MoveAndFace (dungeon16, 3)
        </script>
      </exit>
      <exit name="South17" alias="south" to="defaultroom">
        <inherit name="southdirection" />
        <runscript />
        <script type="script">
          MoveAndFace (dungeon23, 2)
        </script>
      </exit>
      <exit name="East13" alias="east" to="defaultroom">
        <inherit name="eastdirection" />
        <runscript />
        <script type="script">
          MoveAndFace (dungeon18, 1)
        </script>
      </exit>
    </object>
    <object name="dungeon18">
      <inherit name="editor_room" />
      <usedefaultprefix />
      <descriptions type="stringdictionary">
        <item>
          <key>darknorth</key>
          <value>You are in the dungeon hallway. It is hard to see. You are facing a cell door to another prison cell, it is locked. You can see some bones scattered about the cell. A rat squeaks and runs into the darkness.</value>
        </item>
        <item>
          <key>darkeast</key>
          <value>You are in the dungeon hallway. It is hard to see.</value>
        </item>
        <item>
          <key>darksouth</key>
          <value>You are in the dungeon hallway. It is hard to see.</value>
        </item>
        <item>
          <key>darkwest</key>
          <value>You are in the dungeon hallway. It is hard to see.</value>
        </item>
        <item>
          <key>dimnorth</key>
          <value>TODO: implement this description</value>
        </item>
        <item>
          <key>dimeast</key>
          <value>TODO: implement this description</value>
        </item>
        <item>
          <key>dimsouth</key>
          <value>TODO: implement this description</value>
        </item>
        <item>
          <key>dimwest</key>
          <value>TODO: implement this description</value>
        </item>
        <item>
          <key>brightnorth</key>
          <value>N/A </value>
        </item>
        <item>
          <key>brighteast</key>
          <value>N/A </value>
        </item>
        <item>
          <key>brightsouth</key>
          <value>N/A </value>
        </item>
        <item>
          <key>brightwest</key>
          <value>N/A </value>
        </item>
      </descriptions>
      <description type="script">
        PrintRoomDesc (False)
      </description>
      <exit name="West13" alias="west" to="defaultroom">
        <inherit name="westdirection" />
        <runscript />
        <visible />
        <script type="script">
          MoveAndFace (dungeon17, 3)
        </script>
      </exit>
      <exit name="South18" alias="south" to="defaultroom">
        <inherit name="southdirection" />
        <runscript />
        <script type="script">
          MoveAndFace (dungeon24, 2)
        </script>
      </exit>
      <exit name="East14" alias="east" to="defaultroom">
        <inherit name="eastdirection" />
        <runscript />
        <script type="script">
          MoveAndFace (dungeon19, 1)
        </script>
      </exit>
    </object>
    <object name="dungeon19">
      <inherit name="editor_room" />
      <usedefaultprefix />
      <descriptions type="stringdictionary">
        <item>
          <key>darknorth</key>
          <value>You are in the dungeon hallway. It is very hard to see. You are facing the cell bars of another prison cell. You can see some bones in the darkness, scattered about the cell floor.</value>
        </item>
        <item>
          <key>darkeast</key>
          <value>You are in the dungeon hallway. It is very hard to see.</value>
        </item>
        <item>
          <key>darksouth</key>
          <value>You are in the dungeon hallway. It is very hard to see.</value>
        </item>
        <item>
          <key>darkwest</key>
          <value>You are in the dungeon hallway. It is very hard to see.</value>
        </item>
        <item>
          <key>dimnorth</key>
          <value>TODO: implement this description</value>
        </item>
        <item>
          <key>dimeast</key>
          <value>TODO: implement this description</value>
        </item>
        <item>
          <key>dimsouth</key>
          <value>TODO: implement this description</value>
        </item>
        <item>
          <key>dimwest</key>
          <value>TODO: implement this description</value>
        </item>
        <item>
          <key>brightnorth</key>
          <value>N/A </value>
        </item>
        <item>
          <key>brighteast</key>
          <value>N/A </value>
        </item>
        <item>
          <key>brightsouth</key>
          <value>N/A </value>
        </item>
        <item>
          <key>brightwest</key>
          <value>N/A </value>
        </item>
      </descriptions>
      <description type="script">
        PrintRoomDesc (False)
      </description>
      <exit name="West14" alias="west" to="defaultroom">
        <inherit name="westdirection" />
        <runscript />
        <visible />
        <script type="script">
          MoveAndFace (dungeon18, 3)
        </script>
      </exit>
      <exit name="South19" alias="south" to="defaultroom">
        <inherit name="southdirection" />
        <runscript />
        <script type="script">
          MoveAndFace (dungeon25, 2)
        </script>
      </exit>
      <exit name="East15" alias="east" to="defaultroom">
        <inherit name="eastdirection" />
        <runscript />
        <script type="script">
          MoveAndFace (dungeon20, 1)
        </script>
      </exit>
    </object>
    <object name="dungeon20">
      <inherit name="editor_room" />
      <usedefaultprefix />
      <descriptions type="stringdictionary">
        <item>
          <key>darknorth</key>
          <value>You are in the dungeon hallway. It is very hard to see. You can tell you are facing a wall.</value>
        </item>
        <item>
          <key>darkeast</key>
          <value>You are in a dungeon hallway. It is very hard to see. </value>
        </item>
        <item>
          <key>darksouth</key>
          <value>You are in a dungeon hallway. It is very hard to see. </value>
        </item>
        <item>
          <key>darkwest</key>
          <value>You are in a dungeon hallway. It is very hard to see.</value>
        </item>
        <item>
          <key>dimnorth</key>
          <value>TODO: implement this description</value>
        </item>
        <item>
          <key>dimeast</key>
          <value>TODO: implement this description</value>
        </item>
        <item>
          <key>dimsouth</key>
          <value>TODO: implement this description</value>
        </item>
        <item>
          <key>dimwest</key>
          <value>TODO: implement this description</value>
        </item>
        <item>
          <key>brightnorth</key>
          <value>N/A </value>
        </item>
        <item>
          <key>brighteast</key>
          <value>N/A </value>
        </item>
        <item>
          <key>brightsouth</key>
          <value>N/A </value>
        </item>
        <item>
          <key>brightwest</key>
          <value>N/A </value>
        </item>
      </descriptions>
      <description type="script">
        PrintRoomDesc (False)
      </description>
      <exit name="West15" alias="west" to="defaultroom">
        <inherit name="westdirection" />
        <runscript />
        <visible />
        <script type="script">
          MoveAndFace (dungeon19, 3)
        </script>
      </exit>
      <exit name="South20" alias="south" to="defaultroom">
        <inherit name="southdirection" />
        <runscript />
        <script type="script">
          MoveAndFace (dungeon26, 2)
        </script>
      </exit>
      <exit name="East16" alias="east" to="defaultroom">
        <inherit name="eastdirection" />
        <runscript />
        <script type="script">
          MoveAndFace (dungeon21, 1)
        </script>
      </exit>
    </object>
    <object name="dungeon21">
      <inherit name="editor_room" />
      <usedefaultprefix />
      <descriptions type="stringdictionary">
        <item>
          <key>darknorth</key>
          <value>You are in a dungeon hallway. It is extremely hard to see. You can tell there is a staircase in front of you.</value>
        </item>
        <item>
          <key>darkeast</key>
          <value>You are in a dungeon hallway. It is extremely hard to see. You can tell you are facing a wall.</value>
        </item>
        <item>
          <key>darksouth</key>
          <value>You are in a dungeon hallway. It is extremely hard to see.</value>
        </item>
        <item>
          <key>darkwest</key>
          <value>You are in a dungeon hallway. It is extremely hard to see.</value>
        </item>
        <item>
          <key>dimnorth</key>
          <value>TODO: implement this description</value>
        </item>
        <item>
          <key>dimeast</key>
          <value>TODO: implement this description</value>
        </item>
        <item>
          <key>dimsouth</key>
          <value>TODO: implement this description</value>
        </item>
        <item>
          <key>dimwest</key>
          <value>TODO: implement this description</value>
        </item>
        <item>
          <key>brightnorth</key>
          <value>N/A </value>
        </item>
        <item>
          <key>brighteast</key>
          <value>N/A </value>
        </item>
        <item>
          <key>brightsouth</key>
          <value>N/A </value>
        </item>
        <item>
          <key>brightwest</key>
          <value>N/A </value>
        </item>
      </descriptions>
      <description type="script">
        PrintRoomDesc (False)
      </description>
      <exit name="West16" alias="west" to="defaultroom">
        <inherit name="westdirection" />
        <runscript />
        <visible />
        <script type="script">
          MoveAndFace (dungeon20, 3)
        </script>
      </exit>
      <exit name="South21" alias="south" to="defaultroom">
        <inherit name="southdirection" />
        <runscript />
        <script type="script">
          MoveAndFace (dungeon27, 2)
        </script>
      </exit>
      <exit name="North17" alias="north" to="defaultroom">
        <inherit name="northdirection" />
        <runscript />
        <script type="script">
          MoveAndFace (dungeon13, 0)
        </script>
      </exit>
    </object>
    <object name="dungeon22">
      <inherit name="editor_room" />
      <usedefaultprefix />
      <descriptions type="stringdictionary">
        <item>
          <key>darknorth</key>
          <value>You are in the dungeon hallway. You can see a prison cell a few steps in front of you. </value>
        </item>
        <item>
          <key>darkeast</key>
          <value>You are in the dungeon hallway. </value>
        </item>
        <item>
          <key>darksouth</key>
          <value>You are in the dungeon hallway. You are facing a wall.</value>
        </item>
        <item>
          <key>darkwest</key>
          <value>You are in the dungeon hallway. There is a table in front of you. </value>
        </item>
        <item>
          <key>dimnorth</key>
          <value>TODO: implement this description</value>
        </item>
        <item>
          <key>dimeast</key>
          <value>TODO: implement this description</value>
        </item>
        <item>
          <key>dimsouth</key>
          <value>TODO: implement this description</value>
        </item>
        <item>
          <key>dimwest</key>
          <value>TODO: implement this description</value>
        </item>
        <item>
          <key>brightnorth</key>
          <value>N/A </value>
        </item>
        <item>
          <key>brighteast</key>
          <value>N/A </value>
        </item>
        <item>
          <key>brightsouth</key>
          <value>N/A </value>
        </item>
        <item>
          <key>brightwest</key>
          <value>N/A </value>
        </item>
      </descriptions>
      <description type="script">
        PrintRoomDesc (False)
      </description>
      <exit name="East18" alias="east" to="defaultroom">
        <inherit name="eastdirection" />
        <runscript />
        <script type="script">
          MoveAndFace (dungeon23, 1)
        </script>
      </exit>
      <exit name="North18" alias="north" to="defaultroom">
        <inherit name="northdirection" />
        <runscript />
        <script type="script">
          MoveAndFace (dungeon16, 0)
        </script>
      </exit>
    </object>
    <object name="dungeon23">
      <inherit name="editor_room" />
      <usedefaultprefix />
      <descriptions type="stringdictionary">
        <item>
          <key>darknorth</key>
          <value>You are in a dungeon hallway. It is hard to see.</value>
        </item>
        <item>
          <key>darkeast</key>
          <value>You are in a dungeon hallway. It is hard to see. </value>
        </item>
        <item>
          <key>darksouth</key>
          <value>You are in a dungeon hallway. You are facing a prison cell, it is too dark to see what is inside the cell. </value>
        </item>
        <item>
          <key>darkwest</key>
          <value>You are in a dungeon hallway. It is hard to see.</value>
        </item>
        <item>
          <key>dimnorth</key>
          <value>TODO: implement this description</value>
        </item>
        <item>
          <key>dimeast</key>
          <value>TODO: implement this description</value>
        </item>
        <item>
          <key>dimsouth</key>
          <value>TODO: implement this description</value>
        </item>
        <item>
          <key>dimwest</key>
          <value>TODO: implement this description</value>
        </item>
        <item>
          <key>brightnorth</key>
          <value>N/A </value>
        </item>
        <item>
          <key>brighteast</key>
          <value>N/A </value>
        </item>
        <item>
          <key>brightsouth</key>
          <value>N/A </value>
        </item>
        <item>
          <key>brightwest</key>
          <value>N/A </value>
        </item>
      </descriptions>
      <description type="script">
        PrintRoomDesc (False)
      </description>
      <exit name="West18" alias="west" to="defaultroom">
        <inherit name="westdirection" />
        <runscript />
        <visible />
        <script type="script">
          MoveAndFace (dungeon22, 3)
        </script>
      </exit>
      <exit name="East19" alias="east" to="defaultroom">
        <inherit name="eastdirection" />
        <runscript />
        <script type="script">
          MoveAndFace (dungeon24, 1)
        </script>
      </exit>
      <exit name="North19" alias="north" to="defaultroom">
        <inherit name="northdirection" />
        <runscript />
        <script type="script">
          MoveAndFace (dungeon17, 0)
        </script>
      </exit>
    </object>
    <object name="dungeon24">
      <inherit name="editor_room" />
      <usedefaultprefix />
      <descriptions type="stringdictionary">
        <item>
          <key>darknorth</key>
          <value>You are in a dungeon hallway. It is hard to see.</value>
        </item>
        <item>
          <key>darkeast</key>
          <value>You are in a dungeon hallway. It is hard to see.</value>
        </item>
        <item>
          <key>darksouth</key>
          <value>You are in a dungeon hallway. It is hard to see. You are facing the door to another prison cell, it is locked, and it is too dark to see what is inside of the cell.</value>
        </item>
        <item>
          <key>darkwest</key>
          <value>You are in a dungeon hallway. It is hard to see. </value>
        </item>
        <item>
          <key>dimnorth</key>
          <value>TODO: implement this description</value>
        </item>
        <item>
          <key>dimeast</key>
          <value>TODO: implement this description</value>
        </item>
        <item>
          <key>dimsouth</key>
          <value>TODO: implement this description</value>
        </item>
        <item>
          <key>dimwest</key>
          <value>TODO: implement this description</value>
        </item>
        <item>
          <key>brightnorth</key>
          <value>N/A </value>
        </item>
        <item>
          <key>brighteast</key>
          <value>N/A </value>
        </item>
        <item>
          <key>brightsouth</key>
          <value>N/A </value>
        </item>
        <item>
          <key>brightwest</key>
          <value>N/A </value>
        </item>
      </descriptions>
      <description type="script">
        PrintRoomDesc (False)
      </description>
      <exit name="West19" alias="west" to="defaultroom">
        <inherit name="westdirection" />
        <runscript />
        <visible />
        <script type="script">
          MoveAndFace (dungeon23, 3)
        </script>
      </exit>
      <exit name="East20" alias="east" to="defaultroom">
        <inherit name="eastdirection" />
        <runscript />
        <script type="script">
          MoveAndFace (dungeon25, 1)
        </script>
      </exit>
      <exit name="North20" alias="north" to="defaultroom">
        <inherit name="northdirection" />
        <runscript />
        <script type="script">
          MoveAndFace (dungeon18, 0)
        </script>
      </exit>
    </object>
    <object name="dungeon25">
      <inherit name="editor_room" />
      <usedefaultprefix />
      <descriptions type="stringdictionary">
        <item>
          <key>darknorth</key>
          <value>You are in a dungeon hallway. It is hard to see.</value>
        </item>
        <item>
          <key>darkeast</key>
          <value>You are in a dungeon hallway. It is hard to see.</value>
        </item>
        <item>
          <key>darksouth</key>
          <value>You are in a dungeon hallway. It is hard to see. You are facing the bars to a prison cell, but it is too dark to see inside the cell. </value>
        </item>
        <item>
          <key>darkwest</key>
          <value>You are in a dungeon hallway. It is hard to see.</value>
        </item>
        <item>
          <key>dimnorth</key>
          <value>TODO: implement this description</value>
        </item>
        <item>
          <key>dimeast</key>
          <value>TODO: implement this description</value>
        </item>
        <item>
          <key>dimsouth</key>
          <value>TODO: implement this description</value>
        </item>
        <item>
          <key>dimwest</key>
          <value>TODO: implement this description</value>
        </item>
        <item>
          <key>brightnorth</key>
          <value>N/A </value>
        </item>
        <item>
          <key>brighteast</key>
          <value>N/A </value>
        </item>
        <item>
          <key>brightsouth</key>
          <value>N/A </value>
        </item>
        <item>
          <key>brightwest</key>
          <value>N/A </value>
        </item>
      </descriptions>
      <description type="script">
        PrintRoomDesc (False)
      </description>
      <exit name="West20" alias="west" to="defaultroom">
        <inherit name="westdirection" />
        <runscript />
        <visible />
        <script type="script">
          MoveAndFace (dungeon24, 3)
        </script>
      </exit>
      <exit name="East21" alias="east" to="defaultroom">
        <inherit name="eastdirection" />
        <runscript />
        <script type="script">
          MoveAndFace (dungeon26, 1)
        </script>
      </exit>
      <exit name="North21" alias="north" to="defaultroom">
        <inherit name="northdirection" />
        <runscript />
        <script type="script">
          MoveAndFace (dungeon19, 0)
        </script>
      </exit>
    </object>
    <object name="dungeon26">
      <inherit name="editor_room" />
      <usedefaultprefix />
      <descriptions type="stringdictionary">
        <item>
          <key>darknorth</key>
          <value>You are in a dungeon hallway. It is very hard to see.</value>
        </item>
        <item>
          <key>darkeast</key>
          <value>You are in a dungeon hallway. It is very hard to see.</value>
        </item>
        <item>
          <key>darksouth</key>
          <value>You are in a dungeon hallway. It is very hard to see. You can tell you are facing a wall.</value>
        </item>
        <item>
          <key>darkwest</key>
          <value>You are in a dungeon hallway. It is very hard to see.</value>
        </item>
        <item>
          <key>dimnorth</key>
          <value>TODO: implement this description</value>
        </item>
        <item>
          <key>dimeast</key>
          <value>TODO: implement this description</value>
        </item>
        <item>
          <key>dimsouth</key>
          <value>TODO: implement this description</value>
        </item>
        <item>
          <key>dimwest</key>
          <value>TODO: implement this description</value>
        </item>
        <item>
          <key>brightnorth</key>
          <value>N/A </value>
        </item>
        <item>
          <key>brighteast</key>
          <value>N/A </value>
        </item>
        <item>
          <key>brightsouth</key>
          <value>N/A </value>
        </item>
        <item>
          <key>brightwest</key>
          <value>N/A </value>
        </item>
      </descriptions>
      <description type="script">
        PrintRoomDesc (False)
      </description>
      <exit name="West21" alias="west" to="defaultroom">
        <inherit name="westdirection" />
        <runscript />
        <visible />
        <script type="script">
          MoveAndFace (dungeon25, 3)
        </script>
      </exit>
      <exit name="East22" alias="east" to="defaultroom">
        <inherit name="eastdirection" />
        <runscript />
        <script type="script">
          MoveAndFace (dungeon27, 1)
        </script>
      </exit>
      <exit name="North22" alias="north" to="defaultroom">
        <inherit name="northdirection" />
        <runscript />
        <script type="script">
          MoveAndFace (dungeon20, 0)
        </script>
      </exit>
    </object>
    <object name="dungeon27">
      <inherit name="editor_room" />
      <usedefaultprefix />
      <descriptions type="stringdictionary">
        <item>
          <key>darknorth</key>
          <value>You are in a dungeon hallway. It is extremely hard to see.</value>
        </item>
        <item>
          <key>darkeast</key>
          <value>You are in a dungeon hallway. It is extremely hard to see. You can tell you are facing a wall.</value>
        </item>
        <item>
          <key>darksouth</key>
          <value>You are in a dungeon hallway. It is extremely hard to see. You can tell you are facing a wall.</value>
        </item>
        <item>
          <key>darkwest</key>
          <value>You are in a dungeon hallway. It is extremely hard to see. </value>
        </item>
        <item>
          <key>dimnorth</key>
          <value>TODO: implement this description</value>
        </item>
        <item>
          <key>dimeast</key>
          <value>TODO: implement this description</value>
        </item>
        <item>
          <key>dimsouth</key>
          <value>TODO: implement this description</value>
        </item>
        <item>
          <key>dimwest</key>
          <value>TODO: implement this description</value>
        </item>
        <item>
          <key>brightnorth</key>
          <value>N/A </value>
        </item>
        <item>
          <key>brighteast</key>
          <value>N/A </value>
        </item>
        <item>
          <key>brightsouth</key>
          <value>N/A </value>
        </item>
        <item>
          <key>brightwest</key>
          <value>N/A </value>
        </item>
      </descriptions>
      <description type="script">
        PrintRoomDesc (False)
      </description>
      <exit name="West22" alias="west" to="defaultroom">
        <inherit name="westdirection" />
        <runscript />
        <visible />
        <script type="script">
          MoveAndFace (dungeon26, 3)
        </script>
      </exit>
      <exit name="North23" alias="north" to="defaultroom">
        <inherit name="northdirection" />
        <runscript />
        <script type="script">
          MoveAndFace (dungeon21, 0)
        </script>
      </exit>
    </object>
  </object>
  <object name="hub">
    <inherit name="editor_object" />
    <object name="hub7">
      <inherit name="editor_room" />
      <usedefaultprefix />
      <descriptions type="stringdictionary">
        <item>
          <key>darknorth</key>
          <value>There is a wall a few steps forwards. You are in a small room. The room is lit by the moonlight cascading through large glass panes on the ceiling. The light coats the room in a ghostly glow.</value>
        </item>
        <item>
          <key>darkeast</key>
          <value>There is a chessboard sitting on a small table to the southeast of you. You can see some pieces arranged on the board, but need to get a bit closer to fully make out what they are.</value>
        </item>
        <item>
          <key>darksouth</key>
          <value>There is a chessboard sitting on a table to the southeast of you. You are in a small room that is lit by the moonlight cascading in from large glass panes on the ceiling. (TODO: Alternate for when windows shut: There is a chessboard sitting on a table to the southeast of you. The ceiling has now been closed off by metal shutters to prevent any light from coming in. The room is lit by small torches high up on the walls around the room. The light is quite dim, but you can see without any problems.)</value>
        </item>
        <item>
          <key>darkwest</key>
          <value>You are in a small room, lit by the moonlight cascading through large glass panes in the ceiling. You can see some of the stars through it, including the constellation of Cassiopeia.  (TODO: Alternate for windows being shut: The ceiling has been closed off by metal shutters to prevent any light from coming in. The room is lit by small torches high up on the walls around the room. The light is quite dim, but you can see without any problems.)</value>
        </item>
        <item>
          <key>dimnorth</key>
          <value>N/A </value>
        </item>
        <item>
          <key>dimeast</key>
          <value>N/A </value>
        </item>
        <item>
          <key>dimsouth</key>
          <value>N/A </value>
        </item>
        <item>
          <key>dimwest</key>
          <value>N/A </value>
        </item>
        <item>
          <key>brightnorth</key>
          <value>N/A </value>
        </item>
        <item>
          <key>brighteast</key>
          <value>N/A </value>
        </item>
        <item>
          <key>brightsouth</key>
          <value>N/A </value>
        </item>
        <item>
          <key>brightwest</key>
          <value>N/A </value>
        </item>
      </descriptions>
      <description type="script">
        if (game.part = 3) {
          switch (player.facing_num) {
            case (0) {
              msg ("There is a wall a few steps forwards. The ceiling has now been closed off by metal shutters to prevent any light from coming in. The room is lit by small torches high up on the walls around the room. The light is quite dim, but you can see without any problems.")
            }
            case (2) {
              msg ("There is a chessboard sitting on a table to the southeast of you. The ceiling has now been closed off by metal shutters to prevent any light from coming in. The room is lit by small torches high up on the walls around the room. The light is quite dim, but you can see without any problems.")
            }
            case (3) {
              msg ("The ceiling has been closed off by metal shutters to prevent any light from coming in. The room is lit by small torches high up on the walls around the room. The light is quite dim, but you can see without any problems.")
            }
          }
        }
        else {
          PrintRoomDesc (False)
        }
      </description>
      <exit name="South24" alias="south" to="defaultroom">
        <inherit name="southdirection" />
        <runscript />
        <script type="script">
          MoveAndFace (hub12, 2)
        </script>
      </exit>
      <exit name="East24" alias="east" to="defaultroom">
        <inherit name="eastdirection" />
        <runscript />
        <script type="script">
          MoveAndFace (hub8, 1)
        </script>
      </exit>
    </object>
    <object name="hub8">
      <inherit name="editor_room" />
      <usedefaultprefix />
      <descriptions type="stringdictionary">
        <item>
          <key>darknorth</key>
          <value>There is a door in front of you. It is made of a darkly stained oak, with a tarnished silver handle.</value>
        </item>
        <item>
          <key>darkeast</key>
          <value>There is a chessboard sitting on a small table to the south of you, and a darkly stained oak door to the north.</value>
        </item>
        <item>
          <key>darksouth</key>
          <value>There is a chessboard sitting on a small table in front of you. There are some pieces arranged on the board.</value>
        </item>
        <item>
          <key>darkwest</key>
          <value>There is a chessboard sitting on a small table to the south of you, and a darkly stained oak door to the north.</value>
        </item>
        <item>
          <key>dimnorth</key>
          <value>N/A </value>
        </item>
        <item>
          <key>dimeast</key>
          <value>N/A </value>
        </item>
        <item>
          <key>dimsouth</key>
          <value>N/A </value>
        </item>
        <item>
          <key>dimwest</key>
          <value>N/A </value>
        </item>
        <item>
          <key>brightnorth</key>
          <value>N/A </value>
        </item>
        <item>
          <key>brighteast</key>
          <value>N/A </value>
        </item>
        <item>
          <key>brightsouth</key>
          <value>N/A </value>
        </item>
        <item>
          <key>brightwest</key>
          <value>N/A </value>
        </item>
      </descriptions>
      <description type="script">
        PrintRoomDesc (False)
      </description>
      <exit name="West25" alias="west" to="defaultroom">
        <inherit name="westdirection" />
        <runscript />
        <visible />
        <script type="script">
          MoveAndFace (hub7, 3)
        </script>
      </exit>
      <exit name="East25" alias="east" to="defaultroom">
        <inherit name="eastdirection" />
        <runscript />
        <script type="script">
          MoveAndFace (hub9, 1)
        </script>
      </exit>
      <exit name="North25" alias="north" to="defaultroom">
        <inherit name="northdirection" />
        <runscript />
        <script type="script">
          MoveAndFace (nursery1, 0)
        </script>
      </exit>
    </object>
    <object name="hub9">
      <inherit name="editor_room" />
      <usedefaultprefix />
      <descriptions type="stringdictionary">
        <item>
          <key>darknorth</key>
          <value>There is a wall in front of you. The room is lit by moonlight cascading in through large glass panes in the ceiling. You can see the full moon through the glass. It is large, and imposing.</value>
        </item>
        <item>
          <key>darkeast</key>
          <value>There is a wall in front of you. The room is lit by moonlight cascading in through large glass panes in the ceiling. You can see the full moon through the glass. It is large, and imposing.</value>
        </item>
        <item>
          <key>darksouth</key>
          <value>There is a chessboard to the southwest of you, in the middle of the room. The room is lit by moonlight cascading in from the large glass panes on the ceiling. You can see the full moon through the glass, it is large and imposing.</value>
        </item>
        <item>
          <key>darkwest</key>
          <value>There is a chessboard to the southwest of you, in the middle of the room. The room is lit by moonlight cascading in from the large glass panes on the ceiling. You can see the full moon through the glass, it is large and imposing.</value>
        </item>
        <item>
          <key>dimnorth</key>
          <value>N/A </value>
        </item>
        <item>
          <key>dimeast</key>
          <value>N/A </value>
        </item>
        <item>
          <key>dimsouth</key>
          <value>N/A </value>
        </item>
        <item>
          <key>dimwest</key>
          <value>N/A </value>
        </item>
        <item>
          <key>brightnorth</key>
          <value>N/A </value>
        </item>
        <item>
          <key>brighteast</key>
          <value>N/A </value>
        </item>
        <item>
          <key>brightsouth</key>
          <value>N/A </value>
        </item>
        <item>
          <key>brightwest</key>
          <value>N/A </value>
        </item>
      </descriptions>
      <description type="script">
        if (game.part = 3) {
          switch (player.facing_num) {
            case (0) {
              msg ("There is a in front of you. The ceiling has been closed off by metal shutters to prevent any light from coming in. The room is lit by small torches high up on the walls around the room. The light is quite dim, but you can see without any problems.")
            }
            case (1) {
              msg ("There is a wall a few steps forwards. The ceiling has been closed off by metal shutters to prevent any light from coming in. The room is lit by small torches high up on the walls around the room. The light is quite dim, but you can see without any problems.")
            }
            case (2) {
              msg ("There is a chessboard to the southwest of you, in the middle of the room. The ceiling has been closed off by metal shutters to prevent any light from coming in. The room is lit by small torches high up on the walls around the room. The light is quite dim, but you can see without any problems.")
            }
            case (3) {
              msg ("There is a chessboard to the southwest of you, in the middle of the room. The ceiling has been closed off by metal shutters to prevent any light from coming in. The room is lit by small torches high up on the walls around the room. The light is quite dim, but you can see without any problems.")
            }
          }
        }
        else {
          PrintRoomDesc (False)
        }
      </description>
      <exit name="West26" alias="west" to="defaultroom">
        <inherit name="westdirection" />
        <runscript />
        <visible />
        <script type="script">
          MoveAndFace (hub8, 3)
        </script>
      </exit>
      <exit name="South26" alias="south" to="defaultroom">
        <inherit name="southdirection" />
        <runscript />
        <script type="script">
          MoveAndFace (hub13, 2)
        </script>
      </exit>
    </object>
    <object name="hub12">
      <inherit name="editor_room" />
      <usedefaultprefix />
      <descriptions type="stringdictionary">
        <item>
          <key>darknorth</key>
          <value>There is a chessboard sitting atop a small table to the east of you, and an oak door with a wrought iron handle to the west. </value>
        </item>
        <item>
          <key>darkeast</key>
          <value>There is a chessboard sitting atop a small table in front of you. There are some pieces arrange on the board.</value>
        </item>
        <item>
          <key>darksouth</key>
          <value>There is a chessboard sitting on a small table to the east of you, and an oak door with a wrought iron handle to the west.</value>
        </item>
        <item>
          <key>darkwest</key>
          <value>There is a large oak door in front of you. It has a wrought iron door handle on it.</value>
        </item>
        <item>
          <key>dimnorth</key>
          <value>N/A </value>
        </item>
        <item>
          <key>dimeast</key>
          <value>N/A </value>
        </item>
        <item>
          <key>dimsouth</key>
          <value>N/A </value>
        </item>
        <item>
          <key>dimwest</key>
          <value>N/A </value>
        </item>
        <item>
          <key>brightnorth</key>
          <value>N/A </value>
        </item>
        <item>
          <key>brighteast</key>
          <value>N/A </value>
        </item>
        <item>
          <key>brightsouth</key>
          <value>N/A </value>
        </item>
        <item>
          <key>brightwest</key>
          <value>N/A </value>
        </item>
      </descriptions>
      <description type="script">
        PrintRoomDesc (False)
      </description>
      <enter type="script">
      </enter>
      <exit name="West29" alias="west" to="defaultroom">
        <inherit name="westdirection" />
        <runscript />
        <visible />
        <script type="script">
          if (Got(lantern)) {
            MoveAndFace (kitchen1, 3)
          }
          else {
            msg ("A terrible smell emanates from the room behind the door, but it's too dark to see past the doorway. You feel like you should find a light source before continuing.")
          }
        </script>
      </exit>
      <exit name="South29" alias="south" to="defaultroom">
        <inherit name="southdirection" />
        <runscript />
        <script type="script">
          MoveAndFace (hub15, 2)
        </script>
      </exit>
      <exit name="North29" alias="north" to="defaultroom">
        <inherit name="northdirection" />
        <runscript />
        <script type="script">
          MoveAndFace (hub7, 0)
        </script>
      </exit>
      <object name="chessboard">
        <inherit name="editor_object" />
        <inherit name="surface" />
        <scenery />
        <alt type="stringlist">
          <value>board</value>
        </alt>
        <feature_container />
        <look type="script"><![CDATA[
          if (game.part < 3) {
            msg ("On the board is a single white pawn surrounded by several black pieces.")
            msg ("You can take the pawn using a rook, a knight, a bishop, or a queen.")
          }
          else {
            msg ("The board has a white pawn and a black king diagonally opposed to each other.")
          }
        ]]></look>
        <take type="script">
        </take>
        <object name="rook">
          <inherit name="editor_object" />
          <scenery />
          <feature_usegive />
          <use type="script">
            if (game.part = 1) {
              msg ("You hear a click, as if a door has been unlocked, to the north.")
              UnlockExit (North25)
            }
            else {
              WrongPiece
            }
          </use>
        </object>
        <object name="knight">
          <inherit name="editor_object" />
          <scenery />
          <feature_usegive />
          <use type="script">
            if (game.part = 0) {
              msg ("You hear a click, as if a door has been unlocked, to the west.")
              UnlockExit (West29)
            }
            else {
              WrongPiece
            }
          </use>
        </object>
        <object name="bishop">
          <inherit name="editor_object" />
          <scenery />
          <feature_usegive />
          <use type="script">
            WrongPiece
          </use>
        </object>
        <object name="queen">
          <inherit name="editor_object" />
          <scenery />
          <feature_usegive />
          <use type="script">
            if (game.part = 2) {
              msg ("You hear a click, as if a door has been unlocked, to the east.")
              UnlockExit (East30)
            }
            else {
              WrongPiece
            }
          </use>
        </object>
        <object name="pawn">
          <inherit name="editor_object" />
          <scenery />
          <feature_usegive />
          <use type="script">
            if (game.part = 3) {
              msg ("You move the pawn into place and take the king from the board.")
              msg ("")
              msg ("You dont know why youre here, what anyone wants from you, or how youre going to leave, but you are not going down without a fight. That is all you know.")
              msg ("")
              msg ("You dont feel the same anymore, almost hollow. You know you cant go back to how you were before. Maven... he mentioned there were others, but how many? For how long has this gone on? You are outraged now. You can see smoke billowing in through the dark cherry oak door, the fire has caught up to here now. You remember the shadows fleeing from the fire in the library, just like you. The light of the torches is bright, brighter than you remember. It gives you an idea.")
              msg ("")
              msg ("\"You wont take me. Not now, not ever.\"")
              msg ("")
              msg ("You begin to rip the torches off the wall, and set everything you possibly can on fire -- the table, the chessboard, the doors. You pull at the last torch on the wall, and something clicks. You hear a mechanism, and gears start to push something into motion. The area gets brighter, and brighter, and you look up. The shutters are opening. The large black door bursts open, and an old decrepit man is standing there. He is wear a gold crown, with eyes as black as death itself.")
              msg ("")
              msg ("\"WHAT ARE YOU DOING?!\" He booms, enraged, but he is weak, and the smoke is filling his lungs. A trail of shadow creatures follow him into the room, but howl in pain at the light.")
              msg ("")
              msg ("You are nearly blinded now, and the shutters are almost fully open.")
              msg ("")
              msg ("\"I dont know who you are, what your purpose is, or what is that you do here. All I know is... I know that it is wrong.\" You hiss your words at him.")
              msg ("")
              msg ("You lunge at him with the torch. You blindly swing at him, and feel the end of the torch puncture his chest. You smile.")
              msg ("")
              msg ("The light burns. It burns hotter than you have ever felt, it feels as if you are disintegrating.")
              msg ("")
              msg ("But, it is cleansing. You welcome the searing touch of the sun. The shadows begin to fade off of you. It is too late, because the shadows fade with you.")
              msg ("")
              msg ("The sun cleanses everything. The shadows disappear in howls of pain, and the man... his eyes are clouded over, they are empty now. The death, and the malice they held are no longer there. He is gone now.")
              msg ("")
              msg ("You sigh in relief.")
              msg ("It is over.")
              msg ("You fade into the sunlight.")
              FinishGame
            }
            else {
              msg ("The pawn can't attack any of the other pieces.")
            }
          </use>
        </object>
        <object name="king">
          <inherit name="editor_object" />
          <visible type="boolean">false</visible>
          <scenery />
          <feature_usegive />
          <use type="script">
            msg ("You hear a click, as if a door has been unlocked, to the south.")
            UnlockExit (South33)
          </use>
        </object>
      </object>
    </object>
    <object name="hub13">
      <inherit name="editor_room" />
      <usedefaultprefix />
      <descriptions type="stringdictionary">
        <item>
          <key>darknorth</key>
          <value> There is a large, dark cherry stained, oak door to the east of you. There is a chessboard sitting on a small table to the west.</value>
        </item>
        <item>
          <key>darkeast</key>
          <value>There is a large, dark cherry stained, oak door in front of you. The handle is made of gold, but is plainly crafted.</value>
        </item>
        <item>
          <key>darksouth</key>
          <value>There is a chessboard sitting on a small table to the west of you. There is a large, dark cherry stained, oak door to the east of you. </value>
        </item>
        <item>
          <key>darkwest</key>
          <value>There is a chessboard sitting on a small table in front of you. There are some pieces arranged on it. </value>
        </item>
        <item>
          <key>dimnorth</key>
          <value>N/A </value>
        </item>
        <item>
          <key>dimeast</key>
          <value>N/A </value>
        </item>
        <item>
          <key>dimsouth</key>
          <value>N/A </value>
        </item>
        <item>
          <key>dimwest</key>
          <value>N/A </value>
        </item>
        <item>
          <key>brightnorth</key>
          <value>N/A </value>
        </item>
        <item>
          <key>brighteast</key>
          <value>N/A </value>
        </item>
        <item>
          <key>brightsouth</key>
          <value>N/A </value>
        </item>
        <item>
          <key>brightwest</key>
          <value>N/A </value>
        </item>
      </descriptions>
      <description type="script">
        PrintRoomDesc (False)
      </description>
      <exit name="South30" alias="south" to="defaultroom">
        <inherit name="southdirection" />
        <runscript />
        <script type="script">
          MoveAndFace (hub17, 2)
        </script>
      </exit>
      <exit name="East30" alias="east" to="defaultroom">
        <inherit name="eastdirection" />
        <runscript />
        <script type="script">
          MoveAndFace (library1, 1)
        </script>
      </exit>
      <exit name="North30" alias="north" to="defaultroom">
        <inherit name="northdirection" />
        <runscript />
        <script type="script">
          MoveAndFace (hub9, 0)
        </script>
      </exit>
    </object>
    <object name="hub15">
      <inherit name="editor_room" />
      <usedefaultprefix />
      <descriptions type="stringdictionary">
        <item>
          <key>darknorth</key>
          <value>You are in the corner of a small room. There is a table to the southwest of you. A chessboard lies to the northeast.</value>
        </item>
        <item>
          <key>darkeast</key>
          <value>You are in the corner of a small room. There is a table to the southwest of you. A chessboard lies to the northeast.</value>
        </item>
        <item>
          <key>darksouth</key>
          <value>You are in the corner of a small room, facing a wall. There is a table to the southwest of you.</value>
        </item>
        <item>
          <key>darkwest</key>
          <value>You are in the corner of a small room, facing a wall. There is a table to the southwest of you.</value>
        </item>
        <item>
          <key>dimnorth</key>
          <value>N/A </value>
        </item>
        <item>
          <key>dimeast</key>
          <value>N/A </value>
        </item>
        <item>
          <key>dimsouth</key>
          <value>N/A </value>
        </item>
        <item>
          <key>dimwest</key>
          <value>N/A </value>
        </item>
        <item>
          <key>brightnorth</key>
          <value>N/A </value>
        </item>
        <item>
          <key>brighteast</key>
          <value>N/A </value>
        </item>
        <item>
          <key>brightsouth</key>
          <value>N/A </value>
        </item>
        <item>
          <key>brightwest</key>
          <value>N/A </value>
        </item>
      </descriptions>
      <description type="script">
        PrintRoomDesc (False)
        if (lantern.parent = hub15) {
          msg ("On the southwest corner of the table, there is an unlit lantern.")
        }
      </description>
      <exit name="East32" alias="east" to="defaultroom">
        <inherit name="eastdirection" />
        <runscript />
        <script type="script">
          MoveAndFace (hub16, 1)
        </script>
      </exit>
      <exit name="North32" alias="north" to="defaultroom">
        <inherit name="northdirection" />
        <runscript />
        <script type="script">
          MoveAndFace (hub12, 0)
        </script>
      </exit>
      <object name="lantern">
        <inherit name="editor_object" />
        <inventoryverbs type="stringlist">
          <value>Look at</value>
          <value>Drop</value>
        </inventoryverbs>
        <take />
        <attr name="light_level" type="int">0</attr>
        <drop type="boolean">false</drop>
        <dropmsg>I have a feeling I'll need this soon.</dropmsg>
        <attr name="fuel_level" type="int">80</attr>
        <attr name="burnt_out" type="boolean">false</attr>
        <attr name="low_fuel" type="boolean">false</attr>
        <look type="script"><![CDATA[
          if (Got(lantern)) {
            if (lantern.light_level = 2) {
              msg ("Your lantern is bright.")
            }
            else if (lantern.light_level = 1) {
              msg ("Your lantern is dim.")
            }
            else {
              msg ("Your lantern is off.")
            }
            if (lantern.fuel_level = 80) {
              msg ("Your lantern has full fuel.")
            }
            else if (lantern.fuel_level >= 70) {
              msg ("Your lantern is mostly full.")
            }
            else if (lantern.fuel_level >= 60) {
              msg ("Your lantern is partly full.")
            }
            else if (lantern.fuel_level >= 40) {
              msg ("Your lantern is half empty.")
            }
            else if (lantern.fuel_level >= 25) {
              msg ("Your lantern is running low.")
            }
            else if (lantern.fuel_level > 15) {
              msg ("Your lantern is extremely low.")
            }
            else {
              msg ("Your lantern has run out of fuel.")
            }
          }
          else {
            msg ("The lantern looks like it's still serviceable.")
          }
        ]]></look>
        <turnup type="script"><![CDATA[
          if (Got(lantern)) {
            if (lantern.burnt_out = True and lantern.fuel_level > 0) {
              lantern.burnt_out = False
            }
            if (lantern.low_fuel = True and lantern.fuel_level > 10) {
              lantern.low_fuel = False
            }
            if (lantern.burnt_out) {
              msg ("You can't turn your lantern up since you don't have any fuel.")
            }
            else if (lantern.low_fuel and lantern.light_level = 1) {
              msg ("Your low fuel is limiting how much you can turn your lantern up.")
            }
            else if (lantern.light_level <> 2) {
              lantern.light_level = lantern.light_level + 1
              if (lantern.light_level = 1) {
                msg ("Your lantern is now dim. Your eyes adjust to the new light level.")
                ShowRoomDescription
              }
              else {
                msg ("Your lantern is now bright. Your eyes adjust to the new light level.")
                ShowRoomDescription
              }
            }
            else {
              msg ("Your lantern is already bright.")
            }
          }
          else {
            msg ("I should pick it up before I fiddle with it..")
          }
        ]]></turnup>
        <turndown type="script"><![CDATA[
          if (Got(lantern)) {
            if (lantern.light_level <> 0) {
              lantern.light_level = lantern.light_level - 1
              if (lantern.light_level = 1) {
                msg ("Your lantern is now dim. Your eyes adjust to the new light level.")
                ShowRoomDescription
              }
              else {
                msg ("Your lantern is now off. Your eyes adjust to the new light level.")
                ShowRoomDescription
              }
            }
            else {
              msg ("Your lantern is already off.")
            }
          }
          else {
            msg ("I should pick it up before I fiddle with it...")
          }
        ]]></turndown>
        <ontake type="script">
        </ontake>
        <turnon type="script">
          if (Got(lantern)) {
            if (lantern.light_level = 0) {
              lantern.light_level = 2
              if (lantern.light_level = 2) {
                msg ("Your lantern is now bright. Your eyes adjust to the new light level.")
                ShowRoomDescription
              }
            }
            else {
              msg ("Your lantern is already on.")
            }
          }
          else {
            msg ("I should pick it up before I fiddle with it...")
          }
        </turnon>
        <turnoff type="script"><![CDATA[
          if (Got(lantern)) {
            if (lantern.light_level <> 0) {
              lantern.light_level = 0
              if (lantern.light_level = 0) {
                msg ("Your lantern is now off. Your eyes adjust to the new light level.")
                ShowRoomDescription
              }
            }
            else {
              msg ("Your lantern is already off.")
            }
          }
          else {
            msg ("I should pick it up before I fiddle with it...")
          }
        ]]></turnoff>
        <dim type="script"><![CDATA[
          if (Got(lantern)) {
            if (lantern.light_level <> 1) {
              lantern.light_level = 1
              if (lantern.light_level = 1) {
                msg ("Your lantern is now dim. Your eyes adjust to the new light level.")
                ShowRoomDescription
              }
            }
            else {
              msg ("Your lantern is already dim.")
            }
          }
          else {
            msg ("I should pick it up before I fiddle with it...")
          }
        ]]></dim>
      </object>
    </object>
    <object name="hub16">
      <inherit name="editor_room" />
      <usedefaultprefix />
      <descriptions type="stringdictionary">
        <item>
          <key>darknorth</key>
          <value>There is a chessboard, sitting on a small table, in front of you. There are pieces arranged on the board. </value>
        </item>
        <item>
          <key>darkeast</key>
          <value>There is a chessboard on a small table to the north of you. To the south is a large, ornate, black door. </value>
        </item>
        <item>
          <key>darksouth</key>
          <value>There is a large, ornate, black door in front of you. It is masterfully crafted, and inlayed with gold and jewels. The handle is an ornate, diamond encrusted, round knob. This is the largest, and most imposing of all the doors. </value>
        </item>
        <item>
          <key>darkwest</key>
          <value>There is a chessboard on a small table to the north of you. To the south is a large, ornate, black door. </value>
        </item>
        <item>
          <key>dimnorth</key>
          <value>N/A </value>
        </item>
        <item>
          <key>dimeast</key>
          <value>N/A </value>
        </item>
        <item>
          <key>dimsouth</key>
          <value>N/A </value>
        </item>
        <item>
          <key>dimwest</key>
          <value>N/A </value>
        </item>
        <item>
          <key>brightnorth</key>
          <value>N/A </value>
        </item>
        <item>
          <key>brighteast</key>
          <value>N/A </value>
        </item>
        <item>
          <key>brightsouth</key>
          <value>N/A </value>
        </item>
        <item>
          <key>brightwest</key>
          <value>N/A </value>
        </item>
      </descriptions>
      <description type="script">
        if (game.part = 3) {
          msg ("The ceiling has been closed off by metal shutters to prevent any light from coming in. The room is lit by small torches high up on the walls around the room. The light is quite dim, but you can see without any problems.")
        }
        PrintRoomDesc (False)
      </description>
      <enter type="script">
      </enter>
      <exit name="West33" alias="west" to="defaultroom">
        <inherit name="westdirection" />
        <runscript />
        <visible />
        <script type="script">
          MoveAndFace (hub15, 3)
        </script>
      </exit>
      <exit name="South33" alias="south" to="defaultroom">
        <inherit name="southdirection" />
        <runscript />
        <script type="script">
          msg ("You walk into a long hallway, lit dimly with torches. The path is covered in dust, and cobwebs. It obviously hasnt been traversed in a long time. It feels like every shadow that moves from the flicker of the torches is a creature. Everything seems to leave you be though, so you carry on forwards. You look down at your hands, they are darker than you have ever seen, they almost blend in with the shadows, and you feel hollow. Pressing onwards, you end up in a large room, decorated ornately. There are some shelves with books, tables with silverware, and thick velvet curtains to the floor along all the walls. There is a throne pointed towards one of the windows, you can only see the back of it. You approach the throne, and a creaky voice breaks the silence you were used to. \"Youve made it I see.\" You pause for a moment, calculating.")
          msg ("")
          msg ("\"I am glad. I am getting too old for another trial.\" You are now in front of him. He is old, grey, and decrepit. A gold crown, inlay with all the jewels you can imagine, rests upon his head. His eyes are sunken in, and black, and dead as coal. He stands slowly, and is surprisingly tall for such a frail form.")
          msg ("")
          msg ("\"Why am I here?\" You ask. A small smirk spreads across his lips, and he coughs.")
          msg ("")
          msg ("\"Because I am getting old.\" He replies. You now notice the large staff in his hand, it is topped with a crystal as black as the night. A flame starts to flicker inside the crystal, and you start to feel light headed. You furrow your brow in confusion.")
          msg ("")
          msg ("\"I need to do this to stay alive, you see. Your life energy, for mine.\" He points the staff at you now, and the dizziness intensifies. \"You will be an empty shell of what you once were... just a shadow.\"")
          msg ("")
          msg ("You fall to your knees now, there is no strength left in you. You feel your life draining from you, and you can feel yourself become hollow. Your emotions leave you, and you feel almost robotic and empty; your humanity goes with it, and there is no sense to fight anymore. You see the shadows take over, and you cannot tell where your hand is, and where the shadows begin.")
          msg ("")
          msg ("And then, there is just nothing. Nothing but the shadows, and the light that breaks through them. You feel as if you must hide from the light, and that is the only thing left to feel.")
          msg ("")
          msg ("The man, you can see him now, but he is not the same. He is younger. He is healthier. He is smiling.")
          msg ("")
          msg ("You try to attack, but to no avail, he casts you away with his staff as if you were nothing, and walks off.")
          msg ("")
          msg ("You feel like nothing. You feel nothing. You are nothing. Nothing but a shadow.")
          FinishGame
        </script>
      </exit>
      <exit name="East33" alias="east" to="defaultroom">
        <inherit name="eastdirection" />
        <runscript />
        <script type="script">
          MoveAndFace (hub17, 1)
        </script>
      </exit>
    </object>
    <object name="hub17">
      <inherit name="editor_room" />
      <usedefaultprefix />
      <descriptions type="stringdictionary">
        <item>
          <key>darknorth</key>
          <value>You are in the corner of a small room. There is a chessboard on a small table to the northwest of you. There are some pieces arranged on it. </value>
        </item>
        <item>
          <key>darkeast</key>
          <value>You are in the corner of a small room. There is a large knight statue to the southwest. It feels almost like it is watching you, though it is dusty and does not seem to have moved in ages.</value>
        </item>
        <item>
          <key>darksouth</key>
          <value>You are in the corner of a small room. There is a large knight statue to the southwest. It feels almost like it is watching you, though it is dusty and does not seem to have moved in ages.</value>
        </item>
        <item>
          <key>darkwest</key>
          <value>You are in the corner of a small room. There is a large knight statue towering over you to the south.</value>
        </item>
        <item>
          <key>dimnorth</key>
          <value>N/A </value>
        </item>
        <item>
          <key>dimeast</key>
          <value>N/A </value>
        </item>
        <item>
          <key>dimsouth</key>
          <value>N/A </value>
        </item>
        <item>
          <key>dimwest</key>
          <value>N/A </value>
        </item>
        <item>
          <key>brightnorth</key>
          <value>N/A </value>
        </item>
        <item>
          <key>brighteast</key>
          <value>N/A </value>
        </item>
        <item>
          <key>brightsouth</key>
          <value>N/A </value>
        </item>
        <item>
          <key>brightwest</key>
          <value>N/A </value>
        </item>
      </descriptions>
      <description type="script">
        PrintRoomDesc (False)
      </description>
      <exit name="West34" alias="west" to="defaultroom">
        <inherit name="westdirection" />
        <runscript />
        <visible />
        <script type="script">
          MoveAndFace (hub16, 3)
        </script>
      </exit>
      <exit name="North34" alias="north" to="defaultroom">
        <inherit name="northdirection" />
        <runscript />
        <script type="script">
          MoveAndFace (hub13, 0)
        </script>
      </exit>
    </object>
    <object name="unused">
      <inherit name="editor_object" />
      <object name="hub1">
        <inherit name="editor_room" />
        <usedefaultprefix />
        <descriptions type="stringdictionary">
          <item>
            <key>darknorth</key>
            <value>There is a wall in front of you. You are in the corner of a small room. The wall is made of stone, it is old and covered in cobwebs.</value>
          </item>
          <item>
            <key>darkeast</key>
            <value>There is a wall to the north of you. A few steps forwards, and to the north is a door. </value>
          </item>
          <item>
            <key>darksouth</key>
            <value>There is a wall to the west of you. You are in the corner of a small room. </value>
          </item>
          <item>
            <key>darkwest</key>
            <value>There is a wall in front of you, it is made of stone and it is cold and damp, there is some moss growing on the stone, making it slimy to the touch.</value>
          </item>
          <item>
            <key>dimnorth</key>
            <value>N/A </value>
          </item>
          <item>
            <key>dimeast</key>
            <value>N/A </value>
          </item>
          <item>
            <key>dimsouth</key>
            <value>N/A </value>
          </item>
          <item>
            <key>dimwest</key>
            <value>N/A </value>
          </item>
          <item>
            <key>brightnorth</key>
            <value>N/A </value>
          </item>
          <item>
            <key>brighteast</key>
            <value>N/A </value>
          </item>
          <item>
            <key>brightsouth</key>
            <value>N/A </value>
          </item>
          <item>
            <key>brightwest</key>
            <value>N/A </value>
          </item>
        </descriptions>
        <description type="script">
          PrintRoomDesc (False)
        </description>
        <exit name="South10" alias="south" to="defaultroom">
          <inherit name="southdirection" />
          <runscript />
          <script type="script">
            MoveAndFace (hub6, 2)
          </script>
        </exit>
        <exit name="East1" alias="east" to="defaultroom">
          <inherit name="eastdirection" />
          <runscript />
          <script type="script">
            MoveAndFace (hub2, 1)
          </script>
        </exit>
      </object>
      <object name="hub2">
        <inherit name="editor_room" />
        <usedefaultprefix />
        <descriptions type="stringdictionary">
          <item>
            <key>darknorth</key>
            <value> There is a wall in front of you, it is made of stone. You are in a small room. </value>
          </item>
          <item>
            <key>darkeast</key>
            <value>There is a wall to the north of you. You are in a small room. There is a door a step forwards, and on the north wall.</value>
          </item>
          <item>
            <key>darksouth</key>
            <value>You are in a small room, a few steps to the southeast of you sits a chessboard on a small table. You can see some pieces arranged on the board.</value>
          </item>
          <item>
            <key>darkwest</key>
            <value>There is a wall to the north of you, and a wall a few steps ahead. You are in a small room. </value>
          </item>
          <item>
            <key>dimnorth</key>
            <value>N/A </value>
          </item>
          <item>
            <key>dimeast</key>
            <value>N/A </value>
          </item>
          <item>
            <key>dimsouth</key>
            <value>N/A </value>
          </item>
          <item>
            <key>dimwest</key>
            <value>N/A </value>
          </item>
          <item>
            <key>brightnorth</key>
            <value>N/A </value>
          </item>
          <item>
            <key>brighteast</key>
            <value>N/A </value>
          </item>
          <item>
            <key>brightsouth</key>
            <value>N/A </value>
          </item>
          <item>
            <key>brightwest</key>
            <value>N/A </value>
          </item>
        </descriptions>
        <description type="script">
          PrintRoomDesc (False)
        </description>
        <exit name="West3" alias="west" to="defaultroom">
          <inherit name="westdirection" />
          <runscript />
          <visible />
          <script type="script">
            MoveAndFace (hub1, 3)
          </script>
        </exit>
        <exit name="South12" alias="south" to="defaultroom">
          <inherit name="southdirection" />
          <runscript />
          <script type="script">
            MoveAndFace (hub7, 2)
          </script>
        </exit>
        <exit name="East2" alias="east" to="defaultroom">
          <inherit name="eastdirection" />
          <runscript />
          <script type="script">
            MoveAndFace (hub3, 1)
          </script>
        </exit>
      </object>
      <object name="hub3">
        <inherit name="editor_room" />
        <usedefaultprefix />
        <descriptions type="stringdictionary">
          <item>
            <key>darknorth</key>
            <value> There is a door in front of you. It is made of a darkly stained oak, with a tarnished silver handle. </value>
          </item>
          <item>
            <key>darkeast</key>
            <value>There is a door to the north of you. You are in a small room, there is a chessboard a few steps south of you, located in the middle of the room. </value>
          </item>
          <item>
            <key>darksouth</key>
            <value>You are in a small room. A few steps forwards there is a chessboard sitting on a small table. There are some pieces arranged on the board. </value>
          </item>
          <item>
            <key>darkwest</key>
            <value>There is a door to the north of you. You are in a small room. A few steps south of you is a chessboard sitting on a small table. </value>
          </item>
          <item>
            <key>dimnorth</key>
            <value>N/A </value>
          </item>
          <item>
            <key>dimeast</key>
            <value>N/A </value>
          </item>
          <item>
            <key>dimsouth</key>
            <value>N/A </value>
          </item>
          <item>
            <key>dimwest</key>
            <value>N/A </value>
          </item>
          <item>
            <key>brightnorth</key>
            <value>N/A </value>
          </item>
          <item>
            <key>brighteast</key>
            <value>N/A </value>
          </item>
          <item>
            <key>brightsouth</key>
            <value>N/A </value>
          </item>
          <item>
            <key>brightwest</key>
            <value>N/A </value>
          </item>
        </descriptions>
        <description type="script">
          PrintRoomDesc (False)
        </description>
        <exit name="West8" alias="west" to="defaultroom">
          <inherit name="westdirection" />
          <runscript />
          <visible />
          <script type="script">
            MoveAndFace (hub2, 3)
          </script>
        </exit>
        <exit name="South14" alias="south" to="defaultroom">
          <inherit name="southdirection" />
          <runscript />
          <script type="script">
            MoveAndFace (hub8, 2)
          </script>
        </exit>
        <exit name="East8" alias="east" to="defaultroom">
          <inherit name="eastdirection" />
          <runscript />
          <script type="script">
            MoveAndFace (hub4, 1)
          </script>
        </exit>
        <exit name="North13" alias="north" to="defaultroom">
          <inherit name="northdirection" />
          <runscript />
          <scenery />
          <locked type="boolean">false</locked>
          <script type="script">
            MoveAndFace (nursery1, 0)
          </script>
        </exit>
      </object>
      <object name="hub4">
        <inherit name="editor_room" />
        <usedefaultprefix />
        <descriptions type="stringdictionary">
          <item>
            <key>darknorth</key>
            <value> There is a wall in front of you, it is made of stone. It is damp, and cold, covered in a slimy moss. </value>
          </item>
          <item>
            <key>darkeast</key>
            <value>There is a wall to the north of you. A few steps forwards there is a wall.</value>
          </item>
          <item>
            <key>darksouth</key>
            <value>You are in a small room, the floor is made of old stone slabs, arranged to look like an ornate tiled design. </value>
          </item>
          <item>
            <key>darkwest</key>
            <value>There is a wall to the north of you. There is a door a step forwards on the north wall. </value>
          </item>
          <item>
            <key>dimnorth</key>
            <value>N/A </value>
          </item>
          <item>
            <key>dimeast</key>
            <value>N/A </value>
          </item>
          <item>
            <key>dimsouth</key>
            <value>N/A </value>
          </item>
          <item>
            <key>dimwest</key>
            <value>N/A </value>
          </item>
          <item>
            <key>brightnorth</key>
            <value>N/A </value>
          </item>
          <item>
            <key>brighteast</key>
            <value>N/A </value>
          </item>
          <item>
            <key>brightsouth</key>
            <value>N/A </value>
          </item>
          <item>
            <key>brightwest</key>
            <value>N/A </value>
          </item>
        </descriptions>
        <description type="script">
          PrintRoomDesc (False)
        </description>
        <exit name="West9" alias="west" to="defaultroom">
          <inherit name="westdirection" />
          <runscript />
          <visible />
          <script type="script">
            MoveAndFace (hub3, 3)
          </script>
        </exit>
        <exit name="South15" alias="south" to="defaultroom">
          <inherit name="southdirection" />
          <runscript />
          <script type="script">
            MoveAndFace (hub9, 2)
          </script>
        </exit>
        <exit name="East9" alias="east" to="defaultroom">
          <inherit name="eastdirection" />
          <runscript />
          <script type="script">
            MoveAndFace (hub5, 1)
          </script>
        </exit>
      </object>
      <object name="hub5">
        <inherit name="editor_room" />
        <usedefaultprefix />
        <descriptions type="stringdictionary">
          <item>
            <key>darknorth</key>
            <value> There is a wall in front of you, and to the east of you. You are in the corner of a small room. The wall is made of stone, it is cold and thick with dust.</value>
          </item>
          <item>
            <key>darkeast</key>
            <value>There is a wall in front of you, and to the north of you. You are in the corner of a small room. The wall is made of stone, it is cold and thick with dust.</value>
          </item>
          <item>
            <key>darksouth</key>
            <value>There is a wall to the east of you, you are in the corner of a small room. The floor is made of stone slabs that are arranged to look like an ornate tiled pattern. </value>
          </item>
          <item>
            <key>darkwest</key>
            <value>There is a wall to the north of you. You are in the corner of a small room. </value>
          </item>
          <item>
            <key>dimnorth</key>
            <value>N/A </value>
          </item>
          <item>
            <key>dimeast</key>
            <value>N/A </value>
          </item>
          <item>
            <key>dimsouth</key>
            <value>N/A </value>
          </item>
          <item>
            <key>dimwest</key>
            <value>N/A </value>
          </item>
          <item>
            <key>brightnorth</key>
            <value>N/A </value>
          </item>
          <item>
            <key>brighteast</key>
            <value>N/A </value>
          </item>
          <item>
            <key>brightsouth</key>
            <value>N/A </value>
          </item>
          <item>
            <key>brightwest</key>
            <value>N/A </value>
          </item>
        </descriptions>
        <description type="script">
          PrintRoomDesc (False)
        </description>
        <exit name="South22" alias="south" to="defaultroom">
          <inherit name="southdirection" />
          <runscript />
          <script type="script">
            MoveAndFace (hub10, 2)
          </script>
        </exit>
        <exit name="West2" alias="west" to="defaultroom">
          <inherit name="westdirection" />
          <runscript />
          <visible />
          <script type="script">
            MoveAndFace (hub4, 3)
          </script>
        </exit>
      </object>
      <object name="hub6">
        <inherit name="editor_room" />
        <usedefaultprefix />
        <descriptions type="stringdictionary">
          <item>
            <key>darknorth</key>
            <value>There is a wall to the west of you, and a wall a few steps forwards. You are in a small room. </value>
          </item>
          <item>
            <key>darkeast</key>
            <value>You are in a small room, there is a chessboard sitting on a small table, in the middle of the room. </value>
          </item>
          <item>
            <key>darksouth</key>
            <value>There is a wall to the west of you. There is a door on the western wall a step forwards. It is made of a darkly stained oak.</value>
          </item>
          <item>
            <key>darkwest</key>
            <value>There is a wall in front of you, it is made of stone. It is covered in cobwebs, and you see a spider flit across the wall.</value>
          </item>
          <item>
            <key>dimnorth</key>
            <value>N/A </value>
          </item>
          <item>
            <key>dimeast</key>
            <value>N/A </value>
          </item>
          <item>
            <key>dimsouth</key>
            <value>N/A </value>
          </item>
          <item>
            <key>dimwest</key>
            <value>N/A </value>
          </item>
          <item>
            <key>brightnorth</key>
            <value>N/A </value>
          </item>
          <item>
            <key>brighteast</key>
            <value>N/A </value>
          </item>
          <item>
            <key>brightsouth</key>
            <value>N/A </value>
          </item>
          <item>
            <key>brightwest</key>
            <value>N/A </value>
          </item>
        </descriptions>
        <description type="script">
          PrintRoomDesc (False)
        </description>
        <exit name="South23" alias="south" to="defaultroom">
          <inherit name="southdirection" />
          <runscript />
          <script type="script">
            MoveAndFace (hub11, 2)
          </script>
        </exit>
        <exit name="East23" alias="east" to="defaultroom">
          <inherit name="eastdirection" />
          <runscript />
          <script type="script">
            MoveAndFace (hub7, 1)
          </script>
        </exit>
        <exit name="North16" alias="north" to="defaultroom">
          <inherit name="northdirection" />
          <runscript />
          <script type="script">
            MoveAndFace (hub1, 0)
          </script>
        </exit>
      </object>
      <object name="hub10">
        <inherit name="editor_room" />
        <usedefaultprefix />
        <descriptions type="stringdictionary">
          <item>
            <key>darknorth</key>
            <value>There is a wall to the east of you. You are in a small room.</value>
          </item>
          <item>
            <key>darkeast</key>
            <value>There is a wall in front of you. It is made of stone, and it is cold and damp. You see a centipede crawl through the cracks near the floor.</value>
          </item>
          <item>
            <key>darksouth</key>
            <value>There is a wall to the east of you. A step forwards, on the eastern wall, is a large, dark cherry stained, oak door.</value>
          </item>
          <item>
            <key>darkwest</key>
            <value>There is a chessboard sitting on a table in the middle of the room, a few steps forwards and to the south. </value>
          </item>
          <item>
            <key>dimnorth</key>
            <value>N/A </value>
          </item>
          <item>
            <key>dimeast</key>
            <value>N/A </value>
          </item>
          <item>
            <key>dimsouth</key>
            <value>N/A </value>
          </item>
          <item>
            <key>dimwest</key>
            <value>N/A </value>
          </item>
          <item>
            <key>brightnorth</key>
            <value>N/A </value>
          </item>
          <item>
            <key>brighteast</key>
            <value>N/A </value>
          </item>
          <item>
            <key>brightsouth</key>
            <value>N/A </value>
          </item>
          <item>
            <key>brightwest</key>
            <value>N/A </value>
          </item>
        </descriptions>
        <description type="script">
          PrintRoomDesc (False)
        </description>
        <exit name="West27" alias="west" to="defaultroom">
          <inherit name="westdirection" />
          <runscript />
          <visible />
          <script type="script">
            MoveAndFace (hub9, 3)
          </script>
        </exit>
        <exit name="South27" alias="south" to="defaultroom">
          <inherit name="southdirection" />
          <runscript />
          <script type="script">
            MoveAndFace (hub14, 2)
          </script>
        </exit>
        <exit name="North27" alias="north" to="defaultroom">
          <inherit name="northdirection" />
          <runscript />
          <script type="script">
            MoveAndFace (hub5, 0)
          </script>
        </exit>
      </object>
      <object name="hub11">
        <inherit name="editor_room" />
        <usedefaultprefix />
        <descriptions type="stringdictionary">
          <item>
            <key>darknorth</key>
            <value>There is a large oak door to the west of you. You are in a small room.</value>
          </item>
          <item>
            <key>darkeast</key>
            <value>There is a chessboard sitting on a small table in the middle of the room, a few steps forwards. There is a table to the south of you. </value>
          </item>
          <item>
            <key>darksouth</key>
            <value>There is a table in front of you, there is a few tarnished silver cups and plates sitting on the table, covered in cobwebs and dust. On the south side of the table there is an unlit lantern. There is a large oak door to the west of you. You are in a small room.  (TODO: Alternate for when the lantern is picked up: There is a table in front of you, there is a few tarnished silver cups and plates sitting on the table, covered in cobwebs and dust. There is a large oak door to the west of you. You are in a small room. )</value>
          </item>
          <item>
            <key>darkwest</key>
            <value>There is a large oak door in front of you. It has a wrought iron door handle on it. There is a table to the south of you. </value>
          </item>
          <item>
            <key>dimnorth</key>
            <value>N/A </value>
          </item>
          <item>
            <key>dimeast</key>
            <value>N/A </value>
          </item>
          <item>
            <key>dimsouth</key>
            <value>N/A </value>
          </item>
          <item>
            <key>dimwest</key>
            <value>N/A </value>
          </item>
          <item>
            <key>brightnorth</key>
            <value>N/A </value>
          </item>
          <item>
            <key>brighteast</key>
            <value>N/A </value>
          </item>
          <item>
            <key>brightsouth</key>
            <value>N/A </value>
          </item>
          <item>
            <key>brightwest</key>
            <value>N/A </value>
          </item>
        </descriptions>
        <description type="script">
          PrintRoomDesc (False)
        </description>
        <exit name="West28" alias="west" to="defaultroom">
          <inherit name="westdirection" />
          <runscript />
          <visible />
          <script type="script">
            MoveAndFace (kitchen1, 3)
          </script>
        </exit>
        <exit name="East28" alias="east" to="defaultroom">
          <inherit name="eastdirection" />
          <runscript />
          <script type="script">
            MoveAndFace (hub12, 1)
          </script>
        </exit>
        <exit name="North28" alias="north" to="defaultroom">
          <inherit name="northdirection" />
          <runscript />
          <script type="script">
            MoveAndFace (hub6, 0)
          </script>
        </exit>
      </object>
      <object name="hub14">
        <inherit name="editor_room" />
        <usedefaultprefix />
        <descriptions type="stringdictionary">
          <item>
            <key>darknorth</key>
            <value>There is a large, dark cherry stained, oak door to the east of you, and a chessboard sitting on a small table a few steps to the west. </value>
          </item>
          <item>
            <key>darkeast</key>
            <value>There is a large, dark cherry stained, oak door in front of you. The handle is made of gold, but is plainly crafted. </value>
          </item>
          <item>
            <key>darksouth</key>
            <value>There is a large, dark cherry stained, oak door to the east of you, and a chessboard sitting on a small table a few steps to the west. </value>
          </item>
          <item>
            <key>darkwest</key>
            <value>There is a chessboard sitting on a small table in the middle of the room, a few steps forwards.</value>
          </item>
          <item>
            <key>dimnorth</key>
            <value>N/A </value>
          </item>
          <item>
            <key>dimeast</key>
            <value>N/A </value>
          </item>
          <item>
            <key>dimsouth</key>
            <value>N/A </value>
          </item>
          <item>
            <key>dimwest</key>
            <value>N/A </value>
          </item>
          <item>
            <key>brightnorth</key>
            <value>N/A </value>
          </item>
          <item>
            <key>brighteast</key>
            <value>N/A </value>
          </item>
          <item>
            <key>brightsouth</key>
            <value>N/A </value>
          </item>
          <item>
            <key>brightwest</key>
            <value>N/A </value>
          </item>
        </descriptions>
        <description type="script">
          PrintRoomDesc (False)
        </description>
        <exit name="West31" alias="west" to="defaultroom">
          <inherit name="westdirection" />
          <runscript />
          <visible />
          <script type="script">
            MoveAndFace (hub13, 3)
          </script>
        </exit>
        <exit name="South31" alias="south" to="defaultroom">
          <inherit name="southdirection" />
          <runscript />
          <script type="script">
            MoveAndFace (hub18, 2)
          </script>
        </exit>
        <exit name="East31" alias="east" to="defaultroom">
          <inherit name="eastdirection" />
          <runscript />
          <script type="script">
            MoveAndFace (library1, 1)
          </script>
        </exit>
        <exit name="North31" alias="north" to="defaultroom">
          <inherit name="northdirection" />
          <runscript />
          <script type="script">
            MoveAndFace (hub10, 0)
          </script>
        </exit>
      </object>
      <object name="hub18">
        <inherit name="editor_room" />
        <usedefaultprefix />
        <descriptions type="stringdictionary">
          <item>
            <key>darknorth</key>
            <value> There is a wall to the east of you. There is a large, dark cherry stained, oak door on the eastern wall a step forwards.</value>
          </item>
          <item>
            <key>darkeast</key>
            <value>There is a wall in front of you. It is made of stone, and is cold to the touch. </value>
          </item>
          <item>
            <key>darksouth</key>
            <value>There is a large knight statue taking up the space in front of you. It feels almost like it is watching you, though it is dusty and does not seem to have moved in ages.</value>
          </item>
          <item>
            <key>darkwest</key>
            <value>There is a large knight statue towering over you to the south. You are in the corner of a small room. </value>
          </item>
          <item>
            <key>dimnorth</key>
            <value>N/A </value>
          </item>
          <item>
            <key>dimeast</key>
            <value>N/A </value>
          </item>
          <item>
            <key>dimsouth</key>
            <value>N/A </value>
          </item>
          <item>
            <key>dimwest</key>
            <value>N/A </value>
          </item>
          <item>
            <key>brightnorth</key>
            <value>N/A </value>
          </item>
          <item>
            <key>brighteast</key>
            <value>N/A </value>
          </item>
          <item>
            <key>brightsouth</key>
            <value>N/A </value>
          </item>
          <item>
            <key>brightwest</key>
            <value>N/A </value>
          </item>
        </descriptions>
        <description type="script">
          PrintRoomDesc (False)
        </description>
        <exit name="West35" alias="west" to="defaultroom">
          <inherit name="westdirection" />
          <runscript />
          <visible />
          <script type="script">
            MoveAndFace (hub17, 3)
          </script>
        </exit>
        <exit name="North35" alias="north" to="defaultroom">
          <inherit name="northdirection" />
          <runscript />
          <script type="script">
            MoveAndFace (hub14, 0)
          </script>
        </exit>
      </object>
      <object name="hub19">
        <inherit name="editor_room" />
        <usedefaultprefix />
        <descriptions type="stringdictionary">
          <item>
            <key>darknorth</key>
            <value> There is a table to the west of you, it has an unlit lantern sitting on it.  (TODO: Alternate for when pick up lantern: There is a table to the west of you, there is not much of interest on it.)</value>
          </item>
          <item>
            <key>darkeast</key>
            <value>There is a wall to the south of you. On the southern wall, a step forwards, there is a very large, ornate, black door. It is beautifully crafted. </value>
          </item>
          <item>
            <key>darksouth</key>
            <value>There is a wall in front of you, and a table to the west of you. The table has an unlit lantern on it. (TODO: Alternate for when pick up lantern: There is a wall in front of you, and a table to the west of you. There is not much of interest on it.)</value>
          </item>
          <item>
            <key>darkwest</key>
            <value>There is a table in front of you. There is an unlit lantern sitting on the table. (TODO: Alternate: There is a table in front of you, there is not much of interest of it. There is a wall to the south of you.)</value>
          </item>
          <item>
            <key>dimnorth</key>
            <value>N/A </value>
          </item>
          <item>
            <key>dimeast</key>
            <value>N/A </value>
          </item>
          <item>
            <key>dimsouth</key>
            <value>N/A </value>
          </item>
          <item>
            <key>dimwest</key>
            <value>N/A </value>
          </item>
          <item>
            <key>brightnorth</key>
            <value>N/A </value>
          </item>
          <item>
            <key>brighteast</key>
            <value>N/A </value>
          </item>
          <item>
            <key>brightsouth</key>
            <value>N/A </value>
          </item>
          <item>
            <key>brightwest</key>
            <value>N/A </value>
          </item>
        </descriptions>
        <description type="script">
          PrintRoomDesc (False)
        </description>
        <exit name="East36" alias="east" to="defaultroom">
          <inherit name="eastdirection" />
          <runscript />
          <script type="script">
            MoveAndFace (hub20, 1)
          </script>
        </exit>
        <exit name="North36" alias="north" to="defaultroom">
          <inherit name="northdirection" />
          <runscript />
          <script type="script">
            MoveAndFace (hub15, 0)
          </script>
        </exit>
      </object>
      <object name="hub20">
        <inherit name="editor_room" />
        <usedefaultprefix />
        <descriptions type="stringdictionary">
          <item>
            <key>darknorth</key>
            <value>There is a chessboard sitting on a small table a few steps forwards. You can see some pieces arranged on the board, but cannot tell what they are from here. </value>
          </item>
          <item>
            <key>darkeast</key>
            <value>There is a large, ornate, black door to the south of you. There is a large statue of a knight a few steps forwards. You feel like it is watching you. </value>
          </item>
          <item>
            <key>darksouth</key>
            <value>There is a large, ornate, black door in front of you. It is masterfully crafted, and inlayed with gold and jewels. The handle is an ornate, diamond encrusted, round knob. This is the largest, and most imposing of all the doors. </value>
          </item>
          <item>
            <key>darkwest</key>
            <value>There is a large, ornate, black door to the south of you. There is a chessboard on a small table, in the middle of the room, a few steps to the north.</value>
          </item>
          <item>
            <key>dimnorth</key>
            <value>N/A </value>
          </item>
          <item>
            <key>dimeast</key>
            <value>N/A </value>
          </item>
          <item>
            <key>dimsouth</key>
            <value>N/A </value>
          </item>
          <item>
            <key>dimwest</key>
            <value>N/A </value>
          </item>
          <item>
            <key>brightnorth</key>
            <value>N/A </value>
          </item>
          <item>
            <key>brighteast</key>
            <value>N/A </value>
          </item>
          <item>
            <key>brightsouth</key>
            <value>N/A </value>
          </item>
          <item>
            <key>brightwest</key>
            <value>N/A </value>
          </item>
        </descriptions>
        <description type="script">
          PrintRoomDesc (False)
        </description>
        <exit name="West37" alias="west" to="defaultroom">
          <inherit name="westdirection" />
          <runscript />
          <visible />
          <script type="script">
            MoveAndFace (hub19, 3)
          </script>
        </exit>
        <exit name="East37" alias="east" to="defaultroom">
          <inherit name="eastdirection" />
          <runscript />
          <script type="script">
            MoveAndFace (hub21, 1)
          </script>
        </exit>
        <exit name="North37" alias="north" to="defaultroom">
          <inherit name="northdirection" />
          <runscript />
          <script type="script">
            MoveAndFace (hub16, 0)
          </script>
        </exit>
        <exit name="South25" alias="south" to="defaultroom">
          <inherit name="southdirection" />
          <runscript />
          <script type="script">
            MoveAndFace (hub20, 2)
          </script>
        </exit>
      </object>
      <object name="hub21">
        <inherit name="editor_room" />
        <usedefaultprefix />
        <descriptions type="stringdictionary">
          <item>
            <key>darknorth</key>
            <value> There is a large statue of a knight to the east of you, he is towering over you. You feel like youre being watched. </value>
          </item>
          <item>
            <key>darkeast</key>
            <value>There is a large statue of a knight in front of you. He is towering over you, and although he is covered in a thick film of dust, and has not seemed to have been touched, or moved in ages, you feel as though you are being watched. </value>
          </item>
          <item>
            <key>darksouth</key>
            <value>There is a wall in front of you, and a large statue of a knight to the east of you. </value>
          </item>
          <item>
            <key>darkwest</key>
            <value>There is a wall to the south of you, and on the southern wall a step forwards there is a very large, ornate, black door. </value>
          </item>
          <item>
            <key>dimnorth</key>
            <value>N/A </value>
          </item>
          <item>
            <key>dimeast</key>
            <value>N/A </value>
          </item>
          <item>
            <key>dimsouth</key>
            <value>N/A </value>
          </item>
          <item>
            <key>dimwest</key>
            <value>N/A </value>
          </item>
          <item>
            <key>brightnorth</key>
            <value>N/A </value>
          </item>
          <item>
            <key>brighteast</key>
            <value>N/A </value>
          </item>
          <item>
            <key>brightsouth</key>
            <value>N/A </value>
          </item>
          <item>
            <key>brightwest</key>
            <value>N/A </value>
          </item>
        </descriptions>
        <description type="script">
          PrintRoomDesc (False)
        </description>
        <exit name="West38" alias="west" to="defaultroom">
          <inherit name="westdirection" />
          <runscript />
          <visible />
          <script type="script">
            MoveAndFace (hub20, 3)
          </script>
        </exit>
        <exit name="North38" alias="north" to="defaultroom">
          <inherit name="northdirection" />
          <runscript />
          <script type="script">
            MoveAndFace (hub17, 0)
          </script>
        </exit>
      </object>
    </object>
  </object>
  <object name="kitchen">
    <inherit name="editor_object" />
    <inside type="boolean">false</inside>
    <butcherTimer type="int">0</butcherTimer>
    <object name="kitchen1">
      <inherit name="editor_room" />
      <usedefaultprefix />
      <descriptions type="stringdictionary">
        <item>
          <key>darknorth</key>
          <value>You cannot see anything. You can feel a wall in front of you.</value>
        </item>
        <item>
          <key>darkeast</key>
          <value>You cannot see anything. You can feel a hard surface in front of you.</value>
        </item>
        <item>
          <key>darksouth</key>
          <value>You cannot see anything. You can feel a wall in front of you.</value>
        </item>
        <item>
          <key>darkwest</key>
          <value>You cannot see anything.</value>
        </item>
        <item>
          <key>dimnorth</key>
          <value>You are in a hallway, there is a wall in front of you. There are spots of blood on the ground.</value>
        </item>
        <item>
          <key>dimeast</key>
          <value>You are in a hallway, facing a locked door. Its the door you came in from. There are spots of blood on the ground.</value>
        </item>
        <item>
          <key>dimsouth</key>
          <value>You are in a hallway, there is a wall in front of you. There are spots of blood on the ground.</value>
        </item>
        <item>
          <key>dimwest</key>
          <value>You are in a hallway. There are spots of blood on the ground.</value>
        </item>
        <item>
          <key>brightnorth</key>
          <value>You are in a hallway, there is a wall in front of you. There is a trail of blood on the ground leading west.</value>
        </item>
        <item>
          <key>brighteast</key>
          <value>You are in a hallway, facing a locked door. It is the door you came in from. There are walls on both sides of you.</value>
        </item>
        <item>
          <key>brightsouth</key>
          <value>You are in a hallway, there is a wall in front of you. There is a trail of blood on the ground leading west. </value>
        </item>
        <item>
          <key>brightwest</key>
          <value>You are in a hallway. There is a trail of blood on the ground in front of you, leading forwards.</value>
        </item>
      </descriptions>
      <bloodTrail />
      <description type="script">
        PrintRoomDesc (False)
      </description>
      <enter type="script">
        kitchen.inside = true
      </enter>
      <exit name="East29" alias="east" to="defaultroom">
        <inherit name="eastdirection" />
        <runscript />
        <visible type="boolean">false</visible>
        <script type="script">
          MoveAndFace (hub11, 1)
        </script>
      </exit>
      <exit name="West30" alias="west" to="defaultroom">
        <inherit name="westdirection" />
        <runscript />
        <visible />
        <script type="script">
          MoveAndFace (kitchen2, 3)
        </script>
      </exit>
    </object>
    <object name="kitchen2">
      <inherit name="editor_room" />
      <usedefaultprefix />
      <descriptions type="stringdictionary">
        <item>
          <key>darknorth</key>
          <value>You cannot see anything. You can feel a wall in front of you.</value>
        </item>
        <item>
          <key>darkeast</key>
          <value>You cannot see anything. </value>
        </item>
        <item>
          <key>darksouth</key>
          <value>You cannot see anything. You can feel a wall in front of you.</value>
        </item>
        <item>
          <key>darkwest</key>
          <value>You cannot see anything.</value>
        </item>
        <item>
          <key>dimnorth</key>
          <value>You are in a hallway, there is a wall in front of you. There are spots of blood on the ground.</value>
        </item>
        <item>
          <key>dimeast</key>
          <value>You are in a hallway. There are spots of blood on the ground.</value>
        </item>
        <item>
          <key>dimsouth</key>
          <value>You are in a hallway, there is a wall in front of you. There are spots of blood on the ground.</value>
        </item>
        <item>
          <key>dimwest</key>
          <value>You are in a hallway. There are spots of blood on the ground.</value>
        </item>
        <item>
          <key>brightnorth</key>
          <value>You are in a hallway, there is a wall in front of you. There is a trail of blood on the ground leading west.</value>
        </item>
        <item>
          <key>brighteast</key>
          <value>You are in a hallway. There is a trail of blood on the ground that leads to the door you came in from. </value>
        </item>
        <item>
          <key>brightsouth</key>
          <value>You are in a hallway, there is a wall in front of you. There is a trail of blood on the ground leading west. </value>
        </item>
        <item>
          <key>brightwest</key>
          <value>You are in a hallway. There is a trail of blood on the ground leading forwards. </value>
        </item>
      </descriptions>
      <bloodTrail />
      <description type="script">
        PrintRoomDesc (False)
      </description>
      <exit name="East35" alias="east" to="defaultroom">
        <inherit name="eastdirection" />
        <runscript />
        <script type="script">
          MoveAndFace (kitchen1, 1)
        </script>
      </exit>
      <exit name="West32" alias="west" to="defaultroom">
        <inherit name="westdirection" />
        <runscript />
        <visible />
        <script type="script">
          MoveAndFace (kitchen4, 3)
        </script>
      </exit>
    </object>
    <object name="kitchen3">
      <inherit name="editor_room" />
      <usedefaultprefix />
      <descriptions type="stringdictionary">
        <item>
          <key>darknorth</key>
          <value>You cannot see anything. You can feel a wall in front of you.</value>
        </item>
        <item>
          <key>darkeast</key>
          <value>You cannot see anything. You can feel a wall in front of you.</value>
        </item>
        <item>
          <key>darksouth</key>
          <value>You cannot see anything.</value>
        </item>
        <item>
          <key>darkwest</key>
          <value>You cannot see anything. </value>
        </item>
        <item>
          <key>dimnorth</key>
          <value>You are in a hallway, there is a wall in front of you. You cannot see any blood on the ground.</value>
        </item>
        <item>
          <key>dimeast</key>
          <value>You are in a hallway, there is a wall in front of you. You cannot see any blood on the ground.</value>
        </item>
        <item>
          <key>dimsouth</key>
          <value>You are in a hallway. You cannot see any blood on the ground.</value>
        </item>
        <item>
          <key>dimwest</key>
          <value>You are in a hallway. You cannot see any blood on the ground.</value>
        </item>
        <item>
          <key>brightnorth</key>
          <value>You are in a hallway, there is a wall in front of you. You cannot see the trail of blood from here.</value>
        </item>
        <item>
          <key>brighteast</key>
          <value>You are in a hallway, there is a wall in front of you. You see some blood on the ground to the south of you. </value>
        </item>
        <item>
          <key>brightsouth</key>
          <value>You are in a hallway. You see some blood on the ground a step in front of you. </value>
        </item>
        <item>
          <key>brightwest</key>
          <value>You are in a hallway. You see some blood on the ground to the south of you.</value>
        </item>
      </descriptions>
      <bloodTrail type="boolean">false</bloodTrail>
      <description type="script">
        PrintRoomDesc (False)
      </description>
      <exit name="South38" alias="south" to="defaultroom">
        <inherit name="southdirection" />
        <runscript />
        <script type="script">
          MoveAndFace (kitchen4, 2)
        </script>
      </exit>
      <exit name="West36" alias="west" to="defaultroom">
        <inherit name="westdirection" />
        <runscript />
        <visible />
        <script type="script">
          MoveAndFace (kitchen5, 3)
        </script>
      </exit>
    </object>
    <object name="kitchen4">
      <inherit name="editor_room" />
      <usedefaultprefix />
      <descriptions type="stringdictionary">
        <item>
          <key>darknorth</key>
          <value>You cannot see anything.</value>
        </item>
        <item>
          <key>darkeast</key>
          <value>You cannot see anything. </value>
        </item>
        <item>
          <key>darksouth</key>
          <value>You cannot see anything. You feel a wall in front of you. It is damp and slimy.</value>
        </item>
        <item>
          <key>darkwest</key>
          <value>You cannot see anything. </value>
        </item>
        <item>
          <key>dimnorth</key>
          <value>You are in a hallway. There are spots of blood on the ground.</value>
        </item>
        <item>
          <key>dimeast</key>
          <value>You are in a hallway. There are spots of blood on the ground.</value>
        </item>
        <item>
          <key>dimsouth</key>
          <value>You are in a hallway, there is a wall in front of you. There are spots of blood on the ground.</value>
        </item>
        <item>
          <key>dimwest</key>
          <value>You are in a hallway. There are spots of blood on the ground.</value>
        </item>
        <item>
          <key>brightnorth</key>
          <value>You are in a hallway. There is a trail of blood on the ground leading west.</value>
        </item>
        <item>
          <key>brighteast</key>
          <value>You are in a hallway. There is a trail of blood on the ground leading to the door you came in from.</value>
        </item>
        <item>
          <key>brightsouth</key>
          <value>You are in a hallway, there is a wall in front of you. There is a trail of blood on the ground leading west.</value>
        </item>
        <item>
          <key>brightwest</key>
          <value>You are in a hallway. There is a trail of blood on the ground leading west.</value>
        </item>
      </descriptions>
      <bloodTrail />
      <description type="script">
        PrintRoomDesc (False)
      </description>
      <exit name="North39" alias="north" to="defaultroom">
        <inherit name="northdirection" />
        <runscript />
        <script type="script">
          MoveAndFace (kitchen3, 0)
        </script>
      </exit>
      <exit name="East39" alias="east" to="defaultroom">
        <inherit name="eastdirection" />
        <runscript />
        <script type="script">
          MoveAndFace (kitchen2, 1)
        </script>
      </exit>
      <exit name="West39" alias="west" to="defaultroom">
        <inherit name="westdirection" />
        <runscript />
        <visible />
        <script type="script">
          MoveAndFace (kitchen6, 3)
        </script>
      </exit>
    </object>
    <object name="kitchen5">
      <inherit name="editor_room" />
      <usedefaultprefix />
      <descriptions type="stringdictionary">
        <item>
          <key>darknorth</key>
          <value>You cannot see anything. You can feel a wall in front of you. Its cold.</value>
        </item>
        <item>
          <key>darkeast</key>
          <value>You cannot see anything.</value>
        </item>
        <item>
          <key>darksouth</key>
          <value>You cannot see anything. </value>
        </item>
        <item>
          <key>darkwest</key>
          <value>You cannot see anything.</value>
        </item>
        <item>
          <key>dimnorth</key>
          <value>You are in a hallway, there is a wall in front of you. You cannot see any blood on the ground.</value>
        </item>
        <item>
          <key>dimeast</key>
          <value>You are in a hallway. You cannot see any blood on the ground.</value>
        </item>
        <item>
          <key>dimsouth</key>
          <value>You are in a hallway. You cannot see any blood on the ground.</value>
        </item>
        <item>
          <key>dimwest</key>
          <value>You are in a hallway. You cannot see any blood on the ground.</value>
        </item>
        <item>
          <key>brightnorth</key>
          <value>You are in a hallway, there is a wall in front of you. You cannot see the trail of blood from here.</value>
        </item>
        <item>
          <key>brighteast</key>
          <value>You are in a hallway. You see some blood on the ground to the south of you.</value>
        </item>
        <item>
          <key>brightsouth</key>
          <value>You are in a hallway. You see some blood on the ground a step in front of you.</value>
        </item>
        <item>
          <key>brightwest</key>
          <value>You are in a hallway. You see some blood on the ground to the south of you.</value>
        </item>
      </descriptions>
      <bloodTrail type="boolean">false</bloodTrail>
      <description type="script">
        PrintRoomDesc (False)
      </description>
      <exit name="East40" alias="east" to="defaultroom">
        <inherit name="eastdirection" />
        <runscript />
        <script type="script">
          MoveAndFace (kitchen3, 1)
        </script>
      </exit>
      <exit name="South40" alias="south" to="defaultroom">
        <inherit name="southdirection" />
        <runscript />
        <script type="script">
          MoveAndFace (kitchen6, 2)
        </script>
      </exit>
      <exit name="West40" alias="west" to="defaultroom">
        <inherit name="westdirection" />
        <runscript />
        <visible />
        <script type="script">
          MoveAndFace (kitchen7, 3)
        </script>
      </exit>
    </object>
    <object name="kitchen6">
      <inherit name="editor_room" />
      <usedefaultprefix />
      <descriptions type="stringdictionary">
        <item>
          <key>darknorth</key>
          <value>You cannot see anything. </value>
        </item>
        <item>
          <key>darkeast</key>
          <value>You cannot see anything.</value>
        </item>
        <item>
          <key>darksouth</key>
          <value>You cannot see anything. You can feel a wall in front of you.</value>
        </item>
        <item>
          <key>darkwest</key>
          <value>You cannot see anything. </value>
        </item>
        <item>
          <key>dimnorth</key>
          <value>You are in a hallway. There are spots of blood on the ground.</value>
        </item>
        <item>
          <key>dimeast</key>
          <value>You are in a hallway. There are spots of blood on the ground.</value>
        </item>
        <item>
          <key>dimsouth</key>
          <value>You are in a hallway, there is a wall in front of you. There are spots of blood on the ground.</value>
        </item>
        <item>
          <key>dimwest</key>
          <value>You are in a hallway. There are spots of blood on the ground.</value>
        </item>
        <item>
          <key>brightnorth</key>
          <value>You are in a hallway. There is a trail of blood on the ground leading east, to the door you came in from.</value>
        </item>
        <item>
          <key>brighteast</key>
          <value>You are in a hallway. There is a trail of blood on the ground leading east, to the door you came in from.</value>
        </item>
        <item>
          <key>brightsouth</key>
          <value>You are in a hallway, there is a wall in front of you. There is a trail of blood on the ground leading east, to the door you came in from. </value>
        </item>
        <item>
          <key>brightwest</key>
          <value>You are in a hallway. There is a trail of blood on the ground, but the trail breaks off in front of you.</value>
        </item>
      </descriptions>
      <bloodTrail />
      <description type="script">
        PrintRoomDesc (False)
      </description>
      <exit name="North41" alias="north" to="defaultroom">
        <inherit name="northdirection" />
        <runscript />
        <script type="script">
          MoveAndFace (kitchen5, 0)
        </script>
      </exit>
      <exit name="East41" alias="east" to="defaultroom">
        <inherit name="eastdirection" />
        <runscript />
        <script type="script">
          MoveAndFace (kitchen4, 1)
        </script>
      </exit>
      <exit name="West41" alias="west" to="defaultroom">
        <inherit name="westdirection" />
        <runscript />
        <visible />
        <script type="script">
          MoveAndFace (kitchen8, 3)
        </script>
      </exit>
    </object>
    <object name="kitchen7">
      <inherit name="editor_room" />
      <usedefaultprefix />
      <descriptions type="stringdictionary">
        <item>
          <key>darknorth</key>
          <value>You cannot see anything. You can feel a wall in front of you. It is damp and slimy.</value>
        </item>
        <item>
          <key>darkeast</key>
          <value>You cannot see anything.</value>
        </item>
        <item>
          <key>darksouth</key>
          <value>You cannot see anything.</value>
        </item>
        <item>
          <key>darkwest</key>
          <value>You cannot see anything. </value>
        </item>
        <item>
          <key>dimnorth</key>
          <value>You are in a hallway, there is a wall in front of you. You cannot see any blood on the ground.</value>
        </item>
        <item>
          <key>dimeast</key>
          <value>You are in a hallway. You cannot see any blood on the ground.</value>
        </item>
        <item>
          <key>dimsouth</key>
          <value>You are in a hallway. You cannot see any blood on the ground.</value>
        </item>
        <item>
          <key>dimwest</key>
          <value>You are in a hallway. You cannot see any blood on the ground.</value>
        </item>
        <item>
          <key>brightnorth</key>
          <value>You are in a hallway, there is a wall in front of you. You cannot see the trail of blood from here.</value>
        </item>
        <item>
          <key>brighteast</key>
          <value>You are in a hallway. You cannot see the trail of blood from here. </value>
        </item>
        <item>
          <key>brightsouth</key>
          <value>You are in a hallway. You think you can see the trail of blood southwest of you, but it is hard to tell.</value>
        </item>
        <item>
          <key>brightwest</key>
          <value>You are in a hallway. You think you can see the trail of blood southwest of you, but it is hard to tell. </value>
        </item>
      </descriptions>
      <bloodTrail type="boolean">false</bloodTrail>
      <description type="script">
        PrintRoomDesc (False)
      </description>
      <exit name="East42" alias="east" to="defaultroom">
        <inherit name="eastdirection" />
        <runscript />
        <script type="script">
          MoveAndFace (kitchen5, 1)
        </script>
      </exit>
      <exit name="South42" alias="south" to="defaultroom">
        <inherit name="southdirection" />
        <runscript />
        <script type="script">
          MoveAndFace (kitchen8, 2)
        </script>
      </exit>
      <exit name="West42" alias="west" to="defaultroom">
        <inherit name="westdirection" />
        <runscript />
        <visible />
        <script type="script">
          MoveAndFace (kitchen9, 3)
        </script>
      </exit>
    </object>
    <object name="kitchen8">
      <inherit name="editor_room" />
      <usedefaultprefix />
      <descriptions type="stringdictionary">
        <item>
          <key>darknorth</key>
          <value>You cannot see anything. </value>
        </item>
        <item>
          <key>darkeast</key>
          <value>You cannot see anything.</value>
        </item>
        <item>
          <key>darksouth</key>
          <value>You cannot see anything. You can feel a wall in front of you. It is damp, and slimy. </value>
        </item>
        <item>
          <key>darkwest</key>
          <value>You cannot see anything. </value>
        </item>
        <item>
          <key>dimnorth</key>
          <value>You are in a hallway. You cannot see any blood on the ground.</value>
        </item>
        <item>
          <key>dimeast</key>
          <value>You are in a hallway. You cannot see any blood on the ground.</value>
        </item>
        <item>
          <key>dimsouth</key>
          <value>You are in a hallway, there is a wall in front of you. You cannot see any blood on the ground.</value>
        </item>
        <item>
          <key>dimwest</key>
          <value>You are in a hallway. You cannot see any blood on the ground.</value>
        </item>
        <item>
          <key>brightnorth</key>
          <value>You are in a hallway. You see some blood on the ground a step to the east of you, and a step to the west of you.</value>
        </item>
        <item>
          <key>brighteast</key>
          <value>You are in a hallway. You can see some blood on the ground a step in front of you. </value>
        </item>
        <item>
          <key>brightsouth</key>
          <value>You are in a hallway, there is a wall in front of you. You can see blood on the ground a step to the east of you, and a step to the west of you.</value>
        </item>
        <item>
          <key>brightwest</key>
          <value>You are in a hallway, there is a wall in front of you. You can see blood on the ground a step in front of you. </value>
        </item>
      </descriptions>
      <bloodTrail type="boolean">false</bloodTrail>
      <description type="script">
        PrintRoomDesc (False)
      </description>
      <exit name="North43" alias="north" to="defaultroom">
        <inherit name="northdirection" />
        <runscript />
        <script type="script">
          MoveAndFace (kitchen7, 0)
        </script>
      </exit>
      <exit name="East43" alias="east" to="defaultroom">
        <inherit name="eastdirection" />
        <runscript />
        <script type="script">
          MoveAndFace (kitchen6, 1)
        </script>
      </exit>
      <exit name="West43" alias="west" to="defaultroom">
        <inherit name="westdirection" />
        <runscript />
        <visible />
        <script type="script">
          MoveAndFace (kitchen10, 3)
        </script>
      </exit>
    </object>
    <object name="kitchen9">
      <inherit name="editor_room" />
      <usedefaultprefix />
      <descriptions type="stringdictionary">
        <item>
          <key>darknorth</key>
          <value>You cannot see anything. You can feel a wall in front of you.</value>
        </item>
        <item>
          <key>darkeast</key>
          <value>You cannot see anything. </value>
        </item>
        <item>
          <key>darksouth</key>
          <value>You cannot see anything. </value>
        </item>
        <item>
          <key>darkwest</key>
          <value>You cannot see anything. </value>
        </item>
        <item>
          <key>dimnorth</key>
          <value>You are in a hallway, there is a wall in front of you. You cannot see any blood on the ground. There is a window, you can see into a small room. You see what appears to be a cask of oil inside the room.</value>
        </item>
        <item>
          <key>dimeast</key>
          <value>You are in a hallway. You cannot see any blood on the ground.</value>
        </item>
        <item>
          <key>dimsouth</key>
          <value>You are in a hallway. You cannot see any blood on the ground.</value>
        </item>
        <item>
          <key>dimwest</key>
          <value>You are in a hallway. You cannot see any blood on the ground. You see a window into a small room to the north of you.</value>
        </item>
        <item>
          <key>brightnorth</key>
          <value>You are in a hallway, there is a wall in front of you. You cannot see the trail of blood from here. There is a window, you can see into a small room. You see a cask of oil inside the room, and the door to the room is a step northwest of you.</value>
        </item>
        <item>
          <key>brighteast</key>
          <value>You are in a hallway. You cannot see the trail of blood from here.</value>
        </item>
        <item>
          <key>brightsouth</key>
          <value>You are in a hallway. You can see blood on the ground a step in front of you.</value>
        </item>
        <item>
          <key>brightwest</key>
          <value>You are in a hallway. You can see some blood on the ground a step south of you. You see a window into a small room to the north of you, you can see into a small room and a cask of oil is visible inside the room.</value>
        </item>
      </descriptions>
      <bloodTrail type="boolean">false</bloodTrail>
      <description type="script">
        PrintRoomDesc (False)
      </description>
      <exit name="East44" alias="east" to="defaultroom">
        <inherit name="eastdirection" />
        <runscript />
        <script type="script">
          MoveAndFace (kitchen7, 1)
        </script>
      </exit>
      <exit name="South44" alias="south" to="defaultroom">
        <inherit name="southdirection" />
        <runscript />
        <script type="script">
          MoveAndFace (kitchen10, 2)
        </script>
      </exit>
      <exit name="West44" alias="west" to="defaultroom">
        <inherit name="westdirection" />
        <runscript />
        <visible />
        <script type="script">
          MoveAndFace (kitchen12, 3)
        </script>
      </exit>
    </object>
    <object name="kitchen10">
      <inherit name="editor_room" />
      <usedefaultprefix />
      <descriptions type="stringdictionary">
        <item>
          <key>darknorth</key>
          <value>You cannot see anything. </value>
        </item>
        <item>
          <key>darkeast</key>
          <value>You cannot see anything. </value>
        </item>
        <item>
          <key>darksouth</key>
          <value>You cannot see anything. You can feel a wall in front of you. Your hand grazes some spider webs, you brush it off but it still feels like the spiders are crawling on your skin.</value>
        </item>
        <item>
          <key>darkwest</key>
          <value>You cannot see anything. </value>
        </item>
        <item>
          <key>dimnorth</key>
          <value>You are in a hallway. There are spots of blood on the ground. You can see the sheen of a glass pane a few steps in front of you. </value>
        </item>
        <item>
          <key>dimeast</key>
          <value>You are in a hallway. There are spots of blood on the ground. You can see the light being reflected off a surface to the north of you.</value>
        </item>
        <item>
          <key>dimsouth</key>
          <value>You are in a hallway, there is a wall in front of you. There are spots of blood on the ground. </value>
        </item>
        <item>
          <key>dimwest</key>
          <value>You are in a hallway. There are spots of blood on the ground. You can see the light being reflected off a surface to the north of you.</value>
        </item>
        <item>
          <key>brightnorth</key>
          <value>You are in a hallway. There is a trail of blood on the ground leading west. You can see a window a few steps in front of you.</value>
        </item>
        <item>
          <key>brighteast</key>
          <value>You are in a hallway. The trail of blood stops a step in front of you. You can see the light being reflected off of a window to the north of you.</value>
        </item>
        <item>
          <key>brightsouth</key>
          <value>You are in a hallway, there is a wall in front of you. There is a trail of blood on the ground leading west.</value>
        </item>
        <item>
          <key>brightwest</key>
          <value>You are in a hallway. There is a trail of blood on the ground leading west. You can see the light being reflected off of a window to the north of you.</value>
        </item>
      </descriptions>
      <bloodTrail />
      <description type="script">
        PrintRoomDesc (False)
      </description>
      <exit name="North45" alias="north" to="defaultroom">
        <inherit name="northdirection" />
        <runscript />
        <script type="script">
          MoveAndFace (kitchen9, 0)
        </script>
      </exit>
      <exit name="East45" alias="east" to="defaultroom">
        <inherit name="eastdirection" />
        <runscript />
        <script type="script">
          MoveAndFace (kitchen8, 1)
        </script>
      </exit>
      <exit name="West45" alias="west" to="defaultroom">
        <inherit name="westdirection" />
        <runscript />
        <visible />
        <script type="script">
          MoveAndFace (kitchen13, 3)
        </script>
      </exit>
    </object>
    <object name="kitchen11">
      <inherit name="editor_room" />
      <usedefaultprefix />
      <descriptions type="stringdictionary">
        <item>
          <key>darknorth</key>
          <value>TODO: implement this description</value>
        </item>
        <item>
          <key>darkeast</key>
          <value>TODO: implement this description</value>
        </item>
        <item>
          <key>darksouth</key>
          <value>TODO: implement this description</value>
        </item>
        <item>
          <key>darkwest</key>
          <value>TODO: implement this description</value>
        </item>
        <item>
          <key>dimnorth</key>
          <value>TODO: implement this description</value>
        </item>
        <item>
          <key>dimeast</key>
          <value>TODO: implement this description</value>
        </item>
        <item>
          <key>dimsouth</key>
          <value>TODO: implement this description</value>
        </item>
        <item>
          <key>dimwest</key>
          <value>TODO: implement this description</value>
        </item>
        <item>
          <key>brightnorth</key>
          <value>TODO: implement this description</value>
        </item>
        <item>
          <key>brighteast</key>
          <value>TODO: implement this description</value>
        </item>
        <item>
          <key>brightsouth</key>
          <value>TODO: implement this description</value>
        </item>
        <item>
          <key>brightwest</key>
          <value>TODO: implement this description</value>
        </item>
      </descriptions>
      <bloodTrail type="boolean">false</bloodTrail>
      <description type="script">
        msg ("You enter a small room. There is a cask of oil sitting on a small table in front of you. As you reach out to touch it, a large shadow overwhelms the room. You can barely see anything except the glint of a butchers knife. The smell of rotting meat overwhelms you to the point of nausea and you keel over, vomiting. You turn your head slightly to see the glint of the knife raising high in the air, then swinging down towards the back of your neck.")
        Die
      </description>
      <exit name="South46" alias="south" to="defaultroom">
        <inherit name="southdirection" />
        <runscript />
        <script type="script">
          MoveAndFace (kitchen12, 2)
        </script>
      </exit>
    </object>
    <object name="kitchen12">
      <inherit name="editor_room" />
      <usedefaultprefix />
      <descriptions type="stringdictionary">
        <item>
          <key>darknorth</key>
          <value>You cannot see anything. You feel a hard surface in front of you.</value>
        </item>
        <item>
          <key>darkeast</key>
          <value>You cannot see anything. </value>
        </item>
        <item>
          <key>darksouth</key>
          <value>You cannot see anything. </value>
        </item>
        <item>
          <key>darkwest</key>
          <value>You cannot see anything. </value>
        </item>
        <item>
          <key>dimnorth</key>
          <value>You are in a hallway, facing a door. You cannot see any blood on the ground.</value>
        </item>
        <item>
          <key>dimeast</key>
          <value>You are in a hallway. You cannot see any blood on the ground. There is a door to the north of you.</value>
        </item>
        <item>
          <key>dimsouth</key>
          <value>You are in a hallway. You cannot see any blood on the ground.</value>
        </item>
        <item>
          <key>dimwest</key>
          <value>You are in a hallway. You cannot see any blood on the ground.</value>
        </item>
        <item>
          <key>brightnorth</key>
          <value>You are in a hallway, facing a door. You cannot see the trail of blood from here.</value>
        </item>
        <item>
          <key>brighteast</key>
          <value>You are in a hallway. You can see some blood on the ground to the south of you, and a door to the north of you.</value>
        </item>
        <item>
          <key>brightsouth</key>
          <value>You are in a hallway. You can see blood on the ground a step in front of you.</value>
        </item>
        <item>
          <key>brightwest</key>
          <value>You are in a hallway. You can see blood on the ground to the west of you, and a door directly north of you.</value>
        </item>
      </descriptions>
      <bloodTrail type="boolean">false</bloodTrail>
      <description type="script">
        PrintRoomDesc (False)
      </description>
      <exit name="North47" alias="north" to="defaultroom">
        <inherit name="northdirection" />
        <runscript />
        <script type="script">
          MoveAndFace (kitchen11, 0)
        </script>
      </exit>
      <exit name="East47" alias="east" to="defaultroom">
        <inherit name="eastdirection" />
        <runscript />
        <script type="script">
          MoveAndFace (kitchen9, 1)
        </script>
      </exit>
      <exit name="South47" alias="south" to="defaultroom">
        <inherit name="southdirection" />
        <runscript />
        <script type="script">
          MoveAndFace (kitchen13, 2)
        </script>
      </exit>
      <exit name="West47" alias="west" to="defaultroom">
        <inherit name="westdirection" />
        <runscript />
        <visible />
        <script type="script">
          MoveAndFace (kitchen14, 3)
        </script>
      </exit>
    </object>
    <object name="kitchen13">
      <inherit name="editor_room" />
      <usedefaultprefix />
      <descriptions type="stringdictionary">
        <item>
          <key>darknorth</key>
          <value>You cannot see anything. </value>
        </item>
        <item>
          <key>darkeast</key>
          <value>You cannot see anything. </value>
        </item>
        <item>
          <key>darksouth</key>
          <value>You cannot see anything. You can feel a wall in front of you. Its cold.</value>
        </item>
        <item>
          <key>darkwest</key>
          <value>You cannot see anything. </value>
        </item>
        <item>
          <key>dimnorth</key>
          <value>You are in a hallway. There are spots of blood on the ground.</value>
        </item>
        <item>
          <key>dimeast</key>
          <value>You are in a hallway. There are spots of blood on the ground.</value>
        </item>
        <item>
          <key>dimsouth</key>
          <value>You are in a hallway, there is a wall in front of you. There are spots of blood on the ground.</value>
        </item>
        <item>
          <key>dimwest</key>
          <value>You are in a hallway. There are spots of blood on the ground.</value>
        </item>
        <item>
          <key>brightnorth</key>
          <value>You are in a hallway. The trail of blood ends in front of you. You see a door a few steps in front of you.</value>
        </item>
        <item>
          <key>brighteast</key>
          <value>You are in a hallway. There is a trail of blood on the ground leading east. You can see a door a few steps to the north.</value>
        </item>
        <item>
          <key>brightsouth</key>
          <value>You are in a hallway, there is a wall in front of you. There is a trail of blood on the ground leading east, the trail breaks off to the west. </value>
        </item>
        <item>
          <key>brightwest</key>
          <value>You are in a hallway. The trail of blood cuts off in front of you.</value>
        </item>
      </descriptions>
      <bloodTrail />
      <description type="script">
        PrintRoomDesc (False)
      </description>
      <exit name="North48" alias="north" to="defaultroom">
        <inherit name="northdirection" />
        <runscript />
        <script type="script">
          MoveAndFace (kitchen12, 0)
        </script>
      </exit>
      <exit name="East48" alias="east" to="defaultroom">
        <inherit name="eastdirection" />
        <runscript />
        <script type="script">
          MoveAndFace (kitchen10, 1)
        </script>
      </exit>
      <exit name="West48" alias="west" to="defaultroom">
        <inherit name="westdirection" />
        <runscript />
        <visible />
        <script type="script">
          MoveAndFace (kitchen15, 3)
        </script>
      </exit>
    </object>
    <object name="kitchen14">
      <inherit name="editor_room" />
      <usedefaultprefix />
      <descriptions type="stringdictionary">
        <item>
          <key>darknorth</key>
          <value>TODO: implement this description</value>
        </item>
        <item>
          <key>darkeast</key>
          <value>You cannot see anything. </value>
        </item>
        <item>
          <key>darksouth</key>
          <value>You cannot see anything. </value>
        </item>
        <item>
          <key>darkwest</key>
          <value>You cannot see anything. </value>
        </item>
        <item>
          <key>dimnorth</key>
          <value>You are in a hallway, there is a wall in front of you. You cannot see any blood, but there is a door to the northeast.</value>
        </item>
        <item>
          <key>dimeast</key>
          <value>You are in a hallway. You cannot see any blood, but there is a door up ahead.</value>
        </item>
        <item>
          <key>dimsouth</key>
          <value>You are in a hallway. You cannot see any blood on the ground. </value>
        </item>
        <item>
          <key>dimwest</key>
          <value>You are in a hallway. You cannot see any blood on the ground.</value>
        </item>
        <item>
          <key>brightnorth</key>
          <value>You are in a hallway, there is a wall in front of you. You cannot see the trail of blood from here, but there is a door to the northeast.</value>
        </item>
        <item>
          <key>brighteast</key>
          <value>You are in a hallway. You cannot see the trail of blood from here, but there is a door northeast of you, and you can see the light of your lantern reflect off a window further east of that.</value>
        </item>
        <item>
          <key>brightsouth</key>
          <value>You are in a hallway. You can see the trail of blood a few steps southeast, and a few steps southwest. </value>
        </item>
        <item>
          <key>brightwest</key>
          <value>You are in a hallway. You can see the trail of blood southwest of you.</value>
        </item>
      </descriptions>
      <bloodTrail type="boolean">false</bloodTrail>
      <description type="script">
        PrintRoomDesc (False)
      </description>
      <exit name="East49" alias="east" to="defaultroom">
        <inherit name="eastdirection" />
        <runscript />
        <script type="script">
          MoveAndFace (kitchen12, 1)
        </script>
      </exit>
      <exit name="South49" alias="south" to="defaultroom">
        <inherit name="southdirection" />
        <runscript />
        <script type="script">
          MoveAndFace (kitchen15, 2)
        </script>
      </exit>
      <exit name="West49" alias="west" to="defaultroom">
        <inherit name="westdirection" />
        <runscript />
        <visible />
        <script type="script">
          MoveAndFace (kitchen16, 3)
        </script>
      </exit>
    </object>
    <object name="kitchen15">
      <inherit name="editor_room" />
      <usedefaultprefix />
      <descriptions type="stringdictionary">
        <item>
          <key>darknorth</key>
          <value>You cannot see anything. </value>
        </item>
        <item>
          <key>darkeast</key>
          <value>You cannot see anything. </value>
        </item>
        <item>
          <key>darksouth</key>
          <value>You cannot see anything. You can feel a wall in front of you. It is cold, and damp.</value>
        </item>
        <item>
          <key>darkwest</key>
          <value>You cannot see anything. </value>
        </item>
        <item>
          <key>dimnorth</key>
          <value>You are in a hallway. You cannot see any blood on the ground.</value>
        </item>
        <item>
          <key>dimeast</key>
          <value>You are in a hallway. You cannot see any blood on the ground.</value>
        </item>
        <item>
          <key>dimsouth</key>
          <value>You are in a hallway. You cannot see any blood on the ground. </value>
        </item>
        <item>
          <key>dimwest</key>
          <value>You are in a hallway. You cannot see any blood on the ground.</value>
        </item>
        <item>
          <key>brightnorth</key>
          <value>You are in a hallway. You cannot see the trail of blood from here.</value>
        </item>
        <item>
          <key>brighteast</key>
          <value>You are in a hallway. You can see some blood on the ground a step in front of you.</value>
        </item>
        <item>
          <key>brightsouth</key>
          <value>You are in a hallway. You can see some blood on the ground a step east of you, and a step west of you.</value>
        </item>
        <item>
          <key>brightwest</key>
          <value>You are in a hallway. You can see the trail of blood a step in front of you.</value>
        </item>
      </descriptions>
      <bloodTrail type="boolean">false</bloodTrail>
      <description type="script">
        PrintRoomDesc (False)
      </description>
      <exit name="North50" alias="north" to="defaultroom">
        <inherit name="northdirection" />
        <runscript />
        <script type="script">
          MoveAndFace (kitchen14, 0)
        </script>
      </exit>
      <exit name="East50" alias="east" to="defaultroom">
        <inherit name="eastdirection" />
        <runscript />
        <script type="script">
          MoveAndFace (kitchen13, 1)
        </script>
      </exit>
      <exit name="West50" alias="west" to="defaultroom">
        <inherit name="westdirection" />
        <runscript />
        <visible />
        <script type="script">
          MoveAndFace (kitchen17, 3)
        </script>
      </exit>
    </object>
    <object name="kitchen16">
      <inherit name="editor_room" />
      <usedefaultprefix />
      <descriptions type="stringdictionary">
        <item>
          <key>darknorth</key>
          <value>You cannot see anything. You can feel a wall in front of you.</value>
        </item>
        <item>
          <key>darkeast</key>
          <value>You cannot see anything. </value>
        </item>
        <item>
          <key>darksouth</key>
          <value>You cannot see anything. </value>
        </item>
        <item>
          <key>darkwest</key>
          <value>You cannot see anything. </value>
        </item>
        <item>
          <key>dimnorth</key>
          <value>You are in a hallway, there is a wall in front of you. You cannot see any blood on the ground.</value>
        </item>
        <item>
          <key>dimeast</key>
          <value>You are in a hallway. You cannot see any blood on the ground.</value>
        </item>
        <item>
          <key>dimsouth</key>
          <value>You are in a hallway. You cannot see any blood on the ground.</value>
        </item>
        <item>
          <key>dimwest</key>
          <value>You are in a hallway. You cannot see any blood on the ground. </value>
        </item>
        <item>
          <key>brightnorth</key>
          <value>You are in a hallway, there is a wall in front of you. You cannot see the trail of blood from here. </value>
        </item>
        <item>
          <key>brighteast</key>
          <value>You are in a hallway. You can see some blood on the ground south of you.</value>
        </item>
        <item>
          <key>brightsouth</key>
          <value>You are in a hallway. You can see some blood on the ground a step in front of you.</value>
        </item>
        <item>
          <key>brightwest</key>
          <value>You are in a hallway. You can see a trail of blood south of you, leading west.</value>
        </item>
      </descriptions>
      <bloodTrail type="boolean">false</bloodTrail>
      <description type="script">
        PrintRoomDesc (False)
      </description>
      <exit name="East51" alias="east" to="defaultroom">
        <inherit name="eastdirection" />
        <runscript />
        <script type="script">
          MoveAndFace (kitchen14, 1)
        </script>
      </exit>
      <exit name="South51" alias="south" to="defaultroom">
        <inherit name="southdirection" />
        <runscript />
        <script type="script">
          MoveAndFace (kitchen17, 2)
        </script>
      </exit>
      <exit name="West51" alias="west" to="defaultroom">
        <inherit name="westdirection" />
        <runscript />
        <visible />
        <script type="script">
          MoveAndFace (kitchen18, 3)
        </script>
      </exit>
    </object>
    <object name="kitchen17">
      <inherit name="editor_room" />
      <usedefaultprefix />
      <descriptions type="stringdictionary">
        <item>
          <key>darknorth</key>
          <value>You cannot see anything. </value>
        </item>
        <item>
          <key>darkeast</key>
          <value>You cannot see anything. </value>
        </item>
        <item>
          <key>darksouth</key>
          <value>You cannot see anything. You can feel a wall in front of you. It is cold and slimy, maybe covered in damp moss.</value>
        </item>
        <item>
          <key>darkwest</key>
          <value>You cannot see anything. </value>
        </item>
        <item>
          <key>dimnorth</key>
          <value>You are in a hallway. There are spots of blood on the ground.</value>
        </item>
        <item>
          <key>dimeast</key>
          <value>You are in a hallway. There are spots of blood on the ground.</value>
        </item>
        <item>
          <key>dimsouth</key>
          <value>You are in a hallway, there is a wall in front of you. There are spots of blood on the ground.</value>
        </item>
        <item>
          <key>dimwest</key>
          <value>You are in a hallway. There are spots of blood on the ground. </value>
        </item>
        <item>
          <key>brightnorth</key>
          <value>You are in a hallway. There is a trail of blood on the ground, leading west.</value>
        </item>
        <item>
          <key>brighteast</key>
          <value>You are in a hallway. You can see that the trail of blood breaks off in front of you.</value>
        </item>
        <item>
          <key>brightsouth</key>
          <value>You are in a hallway, there is a wall in front of you. There is a trail of blood on the ground, leading west.</value>
        </item>
        <item>
          <key>brightwest</key>
          <value>You are in a hallway. There is a trail of blood on the ground leading forwards.</value>
        </item>
      </descriptions>
      <bloodTrail />
      <description type="script">
        PrintRoomDesc (False)
      </description>
      <exit name="North52" alias="north" to="defaultroom">
        <inherit name="northdirection" />
        <runscript />
        <script type="script">
          MoveAndFace (kitchen16, 0)
        </script>
      </exit>
      <exit name="East52" alias="east" to="defaultroom">
        <inherit name="eastdirection" />
        <runscript />
        <script type="script">
          MoveAndFace (kitchen15, 1)
        </script>
      </exit>
      <exit name="West52" alias="west" to="defaultroom">
        <inherit name="westdirection" />
        <runscript />
        <visible />
        <script type="script">
          MoveAndFace (kitchen19, 3)
        </script>
      </exit>
    </object>
    <object name="kitchen18">
      <inherit name="editor_room" />
      <usedefaultprefix />
      <descriptions type="stringdictionary">
        <item>
          <key>darknorth</key>
          <value>You cannot see anything. You can feel a wall in front of you. </value>
        </item>
        <item>
          <key>darkeast</key>
          <value>You cannot see anything. </value>
        </item>
        <item>
          <key>darksouth</key>
          <value>You cannot see anything. </value>
        </item>
        <item>
          <key>darkwest</key>
          <value>You cannot see anything. </value>
        </item>
        <item>
          <key>dimnorth</key>
          <value>You are in a hallway, there is a wall in front of you. You cannot see any blood on the ground.</value>
        </item>
        <item>
          <key>dimeast</key>
          <value>You are in a hallway. You cannot see any blood on the ground.</value>
        </item>
        <item>
          <key>dimsouth</key>
          <value>You are in a hallway. You cannot see any blood on the ground.</value>
        </item>
        <item>
          <key>dimwest</key>
          <value>You are in a hallway. You cannot see any blood on the ground.</value>
        </item>
        <item>
          <key>brightnorth</key>
          <value>You are in a hallway, there is a wall in front of you. You cannot see the trail of blood from here.</value>
        </item>
        <item>
          <key>brighteast</key>
          <value>You are in a hallway. You can see the trail of blood south of you.</value>
        </item>
        <item>
          <key>brightsouth</key>
          <value>You are in a hallway. You can see the trail of blood a step in front of you.</value>
        </item>
        <item>
          <key>brightwest</key>
          <value>You are in a hallway. You can see the trail of blood south of you.</value>
        </item>
      </descriptions>
      <bloodTrail type="boolean">false</bloodTrail>
      <description type="script">
        PrintRoomDesc (False)
      </description>
      <exit name="East53" alias="east" to="defaultroom">
        <inherit name="eastdirection" />
        <runscript />
        <script type="script">
          MoveAndFace (kitchen16, 1)
        </script>
      </exit>
      <exit name="South53" alias="south" to="defaultroom">
        <inherit name="southdirection" />
        <runscript />
        <script type="script">
          MoveAndFace (kitchen19, 2)
        </script>
      </exit>
      <exit name="West53" alias="west" to="defaultroom">
        <inherit name="westdirection" />
        <runscript />
        <visible />
        <script type="script">
          MoveAndFace (kitchen20, 3)
        </script>
      </exit>
    </object>
    <object name="kitchen19">
      <inherit name="editor_room" />
      <usedefaultprefix />
      <descriptions type="stringdictionary">
        <item>
          <key>darknorth</key>
          <value>You cannot see anything. </value>
        </item>
        <item>
          <key>darkeast</key>
          <value>You cannot see anything. </value>
        </item>
        <item>
          <key>darksouth</key>
          <value>You cannot see anything. You can feel a wall in front of you. It is damp and slimy. </value>
        </item>
        <item>
          <key>darkwest</key>
          <value>You cannot see anything. </value>
        </item>
        <item>
          <key>dimnorth</key>
          <value>You are in a hallway. There are spots of blood on the ground.</value>
        </item>
        <item>
          <key>dimeast</key>
          <value>You are in a hallway. There are spots of blood on the ground.</value>
        </item>
        <item>
          <key>dimsouth</key>
          <value>You are in a hallway, there is a wall in front of you. There are spots of blood on the ground.</value>
        </item>
        <item>
          <key>dimwest</key>
          <value>You are in a hallway. There are spots of blood on the ground.</value>
        </item>
        <item>
          <key>brightnorth</key>
          <value>You are in a hallway. The trail of blood continues east, and west of you.</value>
        </item>
        <item>
          <key>brighteast</key>
          <value>You are in a hallway. The trail of blood continues in front of you.</value>
        </item>
        <item>
          <key>brightsouth</key>
          <value>You are in a hallway, there is a wall in front of you. There is a trail of blood on the ground leading east, and west of you.</value>
        </item>
        <item>
          <key>brightwest</key>
          <value>You are in a hallway. There is a trail of blood on the ground leading forwards.</value>
        </item>
      </descriptions>
      <bloodTrail />
      <description type="script">
        PrintRoomDesc (False)
      </description>
      <exit name="North54" alias="north" to="defaultroom">
        <inherit name="northdirection" />
        <runscript />
        <script type="script">
          MoveAndFace (kitchen18, 0)
        </script>
      </exit>
      <exit name="East54" alias="east" to="defaultroom">
        <inherit name="eastdirection" />
        <runscript />
        <script type="script">
          MoveAndFace (kitchen17, 1)
        </script>
      </exit>
      <exit name="West54" alias="west" to="defaultroom">
        <inherit name="westdirection" />
        <runscript />
        <visible />
        <script type="script">
          MoveAndFace (kitchen21, 3)
        </script>
      </exit>
    </object>
    <object name="kitchen20">
      <inherit name="editor_room" />
      <usedefaultprefix />
      <descriptions type="stringdictionary">
        <item>
          <key>darknorth</key>
          <value>You cannot see anything. You can feel a wall in front of you. It is cold.</value>
        </item>
        <item>
          <key>darkeast</key>
          <value>You cannot see anything. </value>
        </item>
        <item>
          <key>darksouth</key>
          <value>You cannot see anything. </value>
        </item>
        <item>
          <key>darkwest</key>
          <value>You cannot see anything. </value>
        </item>
        <item>
          <key>dimnorth</key>
          <value>You are in a hallway, there is a wall in front of you. You cannot see any blood on the ground.</value>
        </item>
        <item>
          <key>dimeast</key>
          <value>You are in a hallway.  You cannot see any blood on the ground.</value>
        </item>
        <item>
          <key>dimsouth</key>
          <value>You are in a hallway. You cannot see any blood on the ground.</value>
        </item>
        <item>
          <key>dimwest</key>
          <value>You are in a hallway. You cannot see any blood on the ground.</value>
        </item>
        <item>
          <key>brightnorth</key>
          <value>You are in a hallway, there is a wall in front of you. You cannot see the trail of blood from here.</value>
        </item>
        <item>
          <key>brighteast</key>
          <value>You are in a hallway. You can see the trail of blood south of you.</value>
        </item>
        <item>
          <key>brightsouth</key>
          <value>You are in a hallway. You can see the trail of blood a step in front of you.</value>
        </item>
        <item>
          <key>brightwest</key>
          <value>You are in a hallway. You can see the trail of blood on the ground south of you.</value>
        </item>
      </descriptions>
      <bloodTrail type="boolean">false</bloodTrail>
      <description type="script">
        PrintRoomDesc (False)
      </description>
      <exit name="East55" alias="east" to="defaultroom">
        <inherit name="eastdirection" />
        <runscript />
        <script type="script">
          MoveAndFace (kitchen18, 1)
        </script>
      </exit>
      <exit name="South55" alias="south" to="defaultroom">
        <inherit name="southdirection" />
        <runscript />
        <script type="script">
          MoveAndFace (kitchen21, 2)
        </script>
      </exit>
      <exit name="West55" alias="west" to="defaultroom">
        <inherit name="westdirection" />
        <runscript />
        <visible />
        <script type="script">
          MoveAndFace (kitchen22, 3)
        </script>
      </exit>
    </object>
    <object name="kitchen21">
      <inherit name="editor_room" />
      <usedefaultprefix />
      <descriptions type="stringdictionary">
        <item>
          <key>darknorth</key>
          <value>You cannot see anything. </value>
        </item>
        <item>
          <key>darkeast</key>
          <value>You cannot see anything. </value>
        </item>
        <item>
          <key>darksouth</key>
          <value>You cannot see anything. You can feel a wall in front of you.</value>
        </item>
        <item>
          <key>darkwest</key>
          <value>You cannot see anything. </value>
        </item>
        <item>
          <key>dimnorth</key>
          <value>You are in a hallway. There are spots of blood on the ground.</value>
        </item>
        <item>
          <key>dimeast</key>
          <value>You are in a hallway. There are spots of blood on the ground.</value>
        </item>
        <item>
          <key>dimsouth</key>
          <value>You are in a hallway, there is a wall in front of you. There are spots of blood on the ground.</value>
        </item>
        <item>
          <key>dimwest</key>
          <value>You are in a hallway. There are spots of blood on the ground.</value>
        </item>
        <item>
          <key>brightnorth</key>
          <value>You are in a hallway. The trail of blood breaks off in front of you. </value>
        </item>
        <item>
          <key>brighteast</key>
          <value>You are in a hallway. The trail of blood continues in front of you.</value>
        </item>
        <item>
          <key>brightsouth</key>
          <value>You are in a hallway, there is a wall in front of you. The trail of blood continues east of you, and breaks off west of you.</value>
        </item>
        <item>
          <key>brightwest</key>
          <value>You are in a hallway. The trail of blood breaks off in front of you.</value>
        </item>
      </descriptions>
      <bloodTrail />
      <description type="script">
        PrintRoomDesc (False)
      </description>
      <exit name="North56" alias="north" to="defaultroom">
        <inherit name="northdirection" />
        <runscript />
        <script type="script">
          MoveAndFace (kitchen20, 0)
        </script>
      </exit>
      <exit name="East56" alias="east" to="defaultroom">
        <inherit name="eastdirection" />
        <runscript />
        <script type="script">
          MoveAndFace (kitchen19, 1)
        </script>
      </exit>
      <exit name="West56" alias="west" to="defaultroom">
        <inherit name="westdirection" />
        <runscript />
        <visible />
        <script type="script">
          MoveAndFace (kitchen23, 3)
        </script>
      </exit>
    </object>
    <object name="kitchen22">
      <inherit name="editor_room" />
      <usedefaultprefix />
      <descriptions type="stringdictionary">
        <item>
          <key>darknorth</key>
          <value>You cannot see anything. You can feel a wall in front of you.</value>
        </item>
        <item>
          <key>darkeast</key>
          <value>You cannot see anything. </value>
        </item>
        <item>
          <key>darksouth</key>
          <value>You cannot see anything. </value>
        </item>
        <item>
          <key>darkwest</key>
          <value>You cannot see anything. </value>
        </item>
        <item>
          <key>dimnorth</key>
          <value>You are in a hallway, there is a wall in front of you. You cannot see any blood on the ground.</value>
        </item>
        <item>
          <key>dimeast</key>
          <value>You are in a hallway. You cannot see any blood on the ground.</value>
        </item>
        <item>
          <key>dimsouth</key>
          <value>You are in a hallway. You cannot see any blood on the ground.</value>
        </item>
        <item>
          <key>dimwest</key>
          <value>You are in a hallway. You cannot see any blood on the ground.</value>
        </item>
        <item>
          <key>brightnorth</key>
          <value>You are in a hallway, there is a wall in front of you. You cannot see the trail of blood from here.</value>
        </item>
        <item>
          <key>brighteast</key>
          <value>You are in a hallway. You cannot see the trail of blood from here.</value>
        </item>
        <item>
          <key>brightsouth</key>
          <value>You are in a hallway. You think you can see some blood on the ground southwest of you.</value>
        </item>
        <item>
          <key>brightwest</key>
          <value>You are in a hallway. You can see the trail of blood southwest of you.</value>
        </item>
      </descriptions>
      <bloodTrail type="boolean">false</bloodTrail>
      <description type="script">
        PrintRoomDesc (False)
      </description>
      <exit name="East57" alias="east" to="defaultroom">
        <inherit name="eastdirection" />
        <runscript />
        <script type="script">
          MoveAndFace (kitchen20, 1)
        </script>
      </exit>
      <exit name="South57" alias="south" to="defaultroom">
        <inherit name="southdirection" />
        <runscript />
        <script type="script">
          MoveAndFace (kitchen23, 2)
        </script>
      </exit>
      <exit name="West57" alias="west" to="defaultroom">
        <inherit name="westdirection" />
        <runscript />
        <visible />
        <script type="script">
          MoveAndFace (kitchen27, 3)
        </script>
      </exit>
    </object>
    <object name="kitchen23">
      <inherit name="editor_room" />
      <usedefaultprefix />
      <descriptions type="stringdictionary">
        <item>
          <key>darknorth</key>
          <value>You cannot see anything. </value>
        </item>
        <item>
          <key>darkeast</key>
          <value>You cannot see anything. </value>
        </item>
        <item>
          <key>darksouth</key>
          <value>You cannot see anything. You can feel a wall in front of you.</value>
        </item>
        <item>
          <key>darkwest</key>
          <value>You cannot see anything. </value>
        </item>
        <item>
          <key>dimnorth</key>
          <value>You are in a hallway. You cannot see any blood on the ground.</value>
        </item>
        <item>
          <key>dimeast</key>
          <value>You are in a hallway. You cannot see any blood on the ground.</value>
        </item>
        <item>
          <key>dimsouth</key>
          <value>You are in a hallway, there is a wall in front of you. You cannot see any blood on the ground.</value>
        </item>
        <item>
          <key>dimwest</key>
          <value>You are in a hallway. You cannot see any blood on the ground.</value>
        </item>
        <item>
          <key>brightnorth</key>
          <value>You are in a hallway. You think you can see some blood on the ground west of you.</value>
        </item>
        <item>
          <key>brighteast</key>
          <value>You are in a hallway. There is some blood on the ground a step in front of you, the trail leads east.</value>
        </item>
        <item>
          <key>brightsouth</key>
          <value>You are in a hallway, there is a wall in front of you. You can see the trail of blood to the east, and to the west of you.</value>
        </item>
        <item>
          <key>brightwest</key>
          <value>You are in a hallway. You can see the trail of blood a step in front of you.</value>
        </item>
      </descriptions>
      <bloodTrail type="boolean">false</bloodTrail>
      <description type="script">
        PrintRoomDesc (False)
      </description>
      <exit name="North58" alias="north" to="defaultroom">
        <inherit name="northdirection" />
        <runscript />
        <script type="script">
          MoveAndFace (kitchen22, 0)
        </script>
      </exit>
      <exit name="East58" alias="east" to="defaultroom">
        <inherit name="eastdirection" />
        <runscript />
        <script type="script">
          MoveAndFace (kitchen21, 1)
        </script>
      </exit>
      <exit name="West58" alias="west" to="defaultroom">
        <inherit name="westdirection" />
        <runscript />
        <visible />
        <script type="script">
          MoveAndFace (kitchen28, 3)
        </script>
      </exit>
    </object>
    <object name="kitchen24">
      <inherit name="editor_room" />
      <usedefaultprefix />
      <descriptions type="stringdictionary">
        <item>
          <key>darknorth</key>
          <value>You cannot see anything. You can feel a wall in front of you.</value>
        </item>
        <item>
          <key>darkeast</key>
          <value>You cannot see anything. You can feel a wall in front of you.</value>
        </item>
        <item>
          <key>darksouth</key>
          <value>You cannot see anything.  You can feel a wall in front of you.</value>
        </item>
        <item>
          <key>darkwest</key>
          <value>You cannot see anything. </value>
        </item>
        <item>
          <key>dimnorth</key>
          <value>You are facing a wall, in a corner. You cannot see any blood on the ground.</value>
        </item>
        <item>
          <key>dimeast</key>
          <value>You are facing a wall, in a corner. You cannot see any blood on the ground.</value>
        </item>
        <item>
          <key>dimsouth</key>
          <value>You are facing a wall, in a corner. You cannot see any blood on the ground.</value>
        </item>
        <item>
          <key>dimwest</key>
          <value>You are facing the only way out of this corner. You cannot see any blood on the ground.</value>
        </item>
        <item>
          <key>brightnorth</key>
          <value>You are facing a wall, in a corner. You cannot see the trail of blood from here.</value>
        </item>
        <item>
          <key>brighteast</key>
          <value>You are facing a wall, in a corner. You cannot see the trail of blood from here.</value>
        </item>
        <item>
          <key>brightsouth</key>
          <value>You are facing a wall, in a corner. You cannot see the trail of blood from here.</value>
        </item>
        <item>
          <key>brightwest</key>
          <value>You are facing the only way out of this corner. You cannot see the trail of blood from here. </value>
        </item>
      </descriptions>
      <bloodTrail type="boolean">false</bloodTrail>
      <description type="script">
        PrintRoomDesc (False)
      </description>
      <exit name="West59" alias="west" to="defaultroom">
        <inherit name="westdirection" />
        <runscript />
        <visible />
        <script type="script">
          MoveAndFace (kitchen32, 3)
        </script>
      </exit>
    </object>
    <object name="kitchen25">
      <inherit name="editor_room" />
      <usedefaultprefix />
      <descriptions type="stringdictionary">
        <item>
          <key>darknorth</key>
          <value>TODO: implement this description</value>
        </item>
        <item>
          <key>darkeast</key>
          <value>TODO: implement this description</value>
        </item>
        <item>
          <key>darksouth</key>
          <value>TODO: implement this description</value>
        </item>
        <item>
          <key>darkwest</key>
          <value>TODO: implement this description</value>
        </item>
        <item>
          <key>dimnorth</key>
          <value>TODO: implement this description</value>
        </item>
        <item>
          <key>dimeast</key>
          <value>TODO: implement this description</value>
        </item>
        <item>
          <key>dimsouth</key>
          <value>TODO: implement this description</value>
        </item>
        <item>
          <key>dimwest</key>
          <value>TODO: implement this description</value>
        </item>
        <item>
          <key>brightnorth</key>
          <value>TODO: implement this description</value>
        </item>
        <item>
          <key>brighteast</key>
          <value>TODO: implement this description</value>
        </item>
        <item>
          <key>brightsouth</key>
          <value>TODO: implement this description</value>
        </item>
        <item>
          <key>brightwest</key>
          <value>TODO: implement this description</value>
        </item>
      </descriptions>
      <bloodTrail type="boolean">false</bloodTrail>
      <description type="script">
        MoveAndFace (kitchen26, 2)
      </description>
      <exit name="South60" alias="south" to="defaultroom">
        <inherit name="southdirection" />
        <runscript />
        <script type="script">
          MoveAndFace (kitchen26, 2)
        </script>
      </exit>
    </object>
    <object name="kitchen26">
      <inherit name="editor_room" />
      <usedefaultprefix />
      <descriptions type="stringdictionary">
        <item>
          <key>darknorth</key>
          <value>You cannot see anything. </value>
        </item>
        <item>
          <key>darkeast</key>
          <value>You cannot see anything. You can feel a wall in front of you.</value>
        </item>
        <item>
          <key>darksouth</key>
          <value>You cannot see anything. </value>
        </item>
        <item>
          <key>darkwest</key>
          <value>You cannot see anything. You can feel a counter in front of you.</value>
        </item>
        <item>
          <key>dimnorth</key>
          <value>There is a counter west of you, and a wall to the east. You cannot see any blood on the ground.</value>
        </item>
        <item>
          <key>dimeast</key>
          <value>There is a wall in front of you. You cannot see any blood on the ground.</value>
        </item>
        <item>
          <key>dimsouth</key>
          <value>There is a counter west of you, and a wall to the east. You cannot see any blood on the ground.</value>
        </item>
        <item>
          <key>dimwest</key>
          <value>There is a counter in front of you. There are some kitchen utensils on the counter, but nothing of actual interest. You cannot see any blood on the ground.</value>
        </item>
        <item>
          <key>brightnorth</key>
          <value>There is a counter west of you, and a wall to the east. You see a dead end a step in front of you. You cannot see the trail of blood from here.</value>
        </item>
        <item>
          <key>brighteast</key>
          <value>There is a wall in front of you. You cannot see the trail of blood from here.</value>
        </item>
        <item>
          <key>brightsouth</key>
          <value>There is a counter west of you, and a wall to the east. You think you can see some blood on the ground to the south of you, but it is hard to tell from here.</value>
        </item>
        <item>
          <key>brightwest</key>
          <value>There is a counter in front of you. There are some kitchen utensils on the counter, but nothing of actual interest. You cannot see the trail of blood from here.</value>
        </item>
      </descriptions>
      <bloodTrail type="boolean">false</bloodTrail>
      <description type="script">
        PrintRoomDesc (False)
      </description>
      <exit name="North61" alias="north" to="defaultroom">
        <inherit name="northdirection" />
        <runscript />
        <script type="script">
          msg ("You fall into a pile of meat that maggots were making a meal of out. You get up, brushing yourself off as quickly as you can.")
          JumpScare
          FaceSouth
          kitchen.butcherTimer = 0
        </script>
      </exit>
      <exit name="South61" alias="south" to="defaultroom">
        <inherit name="southdirection" />
        <runscript />
        <script type="script">
          MoveAndFace (kitchen27, 2)
        </script>
      </exit>
    </object>
    <object name="kitchen27">
      <inherit name="editor_room" />
      <usedefaultprefix />
      <descriptions type="stringdictionary">
        <item>
          <key>darknorth</key>
          <value>You cannot see anything. </value>
        </item>
        <item>
          <key>darkeast</key>
          <value>You cannot see anything. </value>
        </item>
        <item>
          <key>darksouth</key>
          <value>You cannot see anything. </value>
        </item>
        <item>
          <key>darkwest</key>
          <value>You cannot see anything. You can feel a counter in front of you.</value>
        </item>
        <item>
          <key>dimnorth</key>
          <value>There is a counter west of you. There are some pots and pans piled up on the counter. You cannot see any blood on the ground.</value>
        </item>
        <item>
          <key>dimeast</key>
          <value>You cannot see any blood on the ground here.</value>
        </item>
        <item>
          <key>dimsouth</key>
          <value>There is a counter west of you. There are some pots and pans piled up on the counter. You cannot see any blood on the ground here. </value>
        </item>
        <item>
          <key>dimwest</key>
          <value>There is a counter in front of you. There are some pots and pans piled precariously on the counter. You cannot see any blood on the ground.</value>
        </item>
        <item>
          <key>brightnorth</key>
          <value>There is a counter west of you. There are some pots and pans piled up on the counter. You cannot see the trail of blood from here.</value>
        </item>
        <item>
          <key>brighteast</key>
          <value>You can see some blood on the ground a step south of you.</value>
        </item>
        <item>
          <key>brightsouth</key>
          <value>There is a counter west of you. There are some pots and pans piled up on the counter, they look like they might fall. You can see the trail of blood a step in front of you.</value>
        </item>
        <item>
          <key>brightwest</key>
          <value>There is a counter in front of you. There are some pots and pans piled precariously on the counter, if you bump the counter they might fall. You can see the trail of blood south of you.</value>
        </item>
      </descriptions>
      <bloodTrail type="boolean">false</bloodTrail>
      <description type="script">
        PrintRoomDesc (False)
      </description>
      <exit name="North62" alias="north" to="defaultroom">
        <inherit name="northdirection" />
        <runscript />
        <script type="script">
          MoveAndFace (kitchen26, 0)
        </script>
      </exit>
      <exit name="East62" alias="east" to="defaultroom">
        <inherit name="eastdirection" />
        <runscript />
        <script type="script">
          MoveAndFace (kitchen22, 1)
        </script>
      </exit>
      <exit name="South62" alias="south" to="defaultroom">
        <inherit name="southdirection" />
        <runscript />
        <script type="script">
          MoveAndFace (kitchen28, 2)
        </script>
      </exit>
    </object>
    <object name="kitchen28">
      <inherit name="editor_room" />
      <usedefaultprefix />
      <descriptions type="stringdictionary">
        <item>
          <key>darknorth</key>
          <value>You cannot see anything. </value>
        </item>
        <item>
          <key>darkeast</key>
          <value>You cannot see anything. </value>
        </item>
        <item>
          <key>darksouth</key>
          <value>You cannot see anything. </value>
        </item>
        <item>
          <key>darkwest</key>
          <value>You cannot see anything. </value>
        </item>
        <item>
          <key>dimnorth</key>
          <value>There are spots of blood on the ground.</value>
        </item>
        <item>
          <key>dimeast</key>
          <value>There are spots of blood on the ground.</value>
        </item>
        <item>
          <key>dimsouth</key>
          <value>There are spots of blood on the ground.</value>
        </item>
        <item>
          <key>dimwest</key>
          <value>There are spots of blood on the ground.</value>
        </item>
        <item>
          <key>brightnorth</key>
          <value>There is a trail of blood on the ground leading west.</value>
        </item>
        <item>
          <key>brighteast</key>
          <value>There trail of blood breaks off in front of you.</value>
        </item>
        <item>
          <key>brightsouth</key>
          <value>There is a trail of blood on the ground leading west.</value>
        </item>
        <item>
          <key>brightwest</key>
          <value>There is a trail of blood on the ground leading forwards.</value>
        </item>
      </descriptions>
      <bloodTrail />
      <description type="script">
        PrintRoomDesc (False)
      </description>
      <exit name="North63" alias="north" to="defaultroom">
        <inherit name="northdirection" />
        <runscript />
        <script type="script">
          MoveAndFace (kitchen27, 0)
        </script>
      </exit>
      <exit name="East63" alias="east" to="defaultroom">
        <inherit name="eastdirection" />
        <runscript />
        <script type="script">
          MoveAndFace (kitchen23, 1)
        </script>
      </exit>
      <exit name="South63" alias="south" to="defaultroom">
        <inherit name="southdirection" />
        <runscript />
        <script type="script">
          MoveAndFace (kitchen29, 2)
        </script>
      </exit>
      <exit name="West63" alias="west" to="defaultroom">
        <inherit name="westdirection" />
        <runscript />
        <visible />
        <script type="script">
          MoveAndFace (kitchen33, 3)
        </script>
      </exit>
    </object>
    <object name="kitchen29">
      <inherit name="editor_room" />
      <usedefaultprefix />
      <descriptions type="stringdictionary">
        <item>
          <key>darknorth</key>
          <value>You cannot see anything. </value>
        </item>
        <item>
          <key>darkeast</key>
          <value>You cannot see anything. You can feel a wall in front of you. It is cold.</value>
        </item>
        <item>
          <key>darksouth</key>
          <value>You cannot see anything. </value>
        </item>
        <item>
          <key>darkwest</key>
          <value>You cannot see anything. You can feel a counter in front of you.</value>
        </item>
        <item>
          <key>dimnorth</key>
          <value>There is a counter west of you, and a wall to the east. You cannot see any blood on the ground. </value>
        </item>
        <item>
          <key>dimeast</key>
          <value>There is a wall in front of you. You cannot see any blood on the ground.</value>
        </item>
        <item>
          <key>dimsouth</key>
          <value>There is a counter west of you, and wall east of you. You cannot see any blood on the ground.</value>
        </item>
        <item>
          <key>dimwest</key>
          <value>There is a counter in front of you, there are some cutting boards on the counter covered with rotting meat, and maggots. You cannot see any blood on the ground.</value>
        </item>
        <item>
          <key>brightnorth</key>
          <value>There is a counter west of you, and a wall to the east. You can see some blood on the ground a step in front of you.  </value>
        </item>
        <item>
          <key>brighteast</key>
          <value>There is a wall in front of you. You can see some blood on the ground a step north of you.</value>
        </item>
        <item>
          <key>brightsouth</key>
          <value>There is a counter west of you, and wall east of you. You cannot see the trail of blood from here, but you can see there is a dead end a few steps in front of you. </value>
        </item>
        <item>
          <key>brightwest</key>
          <value>There is a counter in front of you. There are some cutting boards on the counter covered with rotting meat, and maggots, but nothing looks useful here. You can see some blood on the ground to the north of you.</value>
        </item>
      </descriptions>
      <bloodTrail type="boolean">false</bloodTrail>
      <description type="script">
        PrintRoomDesc (False)
      </description>
      <exit name="North64" alias="north" to="defaultroom">
        <inherit name="northdirection" />
        <runscript />
        <script type="script">
          MoveAndFace (kitchen28, 0)
        </script>
      </exit>
      <exit name="South64" alias="south" to="defaultroom">
        <inherit name="southdirection" />
        <runscript />
        <script type="script">
          MoveAndFace (kitchen30, 2)
        </script>
      </exit>
    </object>
    <object name="kitchen30">
      <inherit name="editor_room" />
      <usedefaultprefix />
      <descriptions type="stringdictionary">
        <item>
          <key>darknorth</key>
          <value>You cannot see anything. </value>
        </item>
        <item>
          <key>darkeast</key>
          <value>You cannot see anything. You can feel a wall in front of you. It is sticky.</value>
        </item>
        <item>
          <key>darksouth</key>
          <value>You cannot see anything. </value>
        </item>
        <item>
          <key>darkwest</key>
          <value>You cannot see anything.  You can feel a counter in front of you. </value>
        </item>
        <item>
          <key>dimnorth</key>
          <value>There is a counter west of you, and a wall to the east. You cannot see any blood on the ground.</value>
        </item>
        <item>
          <key>dimeast</key>
          <value>There is a wall in front of you. You cannot see any blood on the ground.</value>
        </item>
        <item>
          <key>dimsouth</key>
          <value>There is a wall east of you, and a counter west of you. You cannot see any blood on the ground.</value>
        </item>
        <item>
          <key>dimwest</key>
          <value>There is a counter in front of you. You cannot see any blood on the ground.</value>
        </item>
        <item>
          <key>brightnorth</key>
          <value>There is a counter west of you, and a wall to the east. You can see some blood on the ground a few steps north of you.</value>
        </item>
        <item>
          <key>brighteast</key>
          <value>There is a wall in front of you. You cannot see the trail of blood from here.</value>
        </item>
        <item>
          <key>brightsouth</key>
          <value>There is a wall east of you, and a counter west of you. You cannot see the trail of blood from here, but you can see a dead end up ahead. </value>
        </item>
        <item>
          <key>brightwest</key>
          <value>There is a counter in front of you. There is nothing of interest on it. You think you can see some blood on the ground to the north of you, but it is hard to tell. You can see that there is a dead end south of you.</value>
        </item>
      </descriptions>
      <bloodTrail type="boolean">false</bloodTrail>
      <description type="script">
        PrintRoomDesc (False)
      </description>
      <exit name="North65" alias="north" to="defaultroom">
        <inherit name="northdirection" />
        <runscript />
        <script type="script">
          MoveAndFace (kitchen29, 0)
        </script>
      </exit>
      <exit name="South65" alias="south" to="defaultroom">
        <inherit name="southdirection" />
        <runscript />
        <script type="script">
          msg ("You hear the sound of a blade being sharpened moving closer and closer. You swing your lantern around trying to find the source, but it hits the countertop and topples out of your hands, spilling oil everywhere. The noises stop.")
          JumpScare
          lantern.fuel_level = lantern.fuel_level - 15
          FaceNorth
        </script>
      </exit>
    </object>
    <object name="kitchen31">
      <inherit name="editor_room" />
      <usedefaultprefix />
      <descriptions type="stringdictionary">
        <item>
          <key>darknorth</key>
          <value>TODO: implement this description</value>
        </item>
        <item>
          <key>darkeast</key>
          <value>TODO: implement this description</value>
        </item>
        <item>
          <key>darksouth</key>
          <value>TODO: implement this description</value>
        </item>
        <item>
          <key>darkwest</key>
          <value>TODO: implement this description</value>
        </item>
        <item>
          <key>dimnorth</key>
          <value>TODO: implement this description</value>
        </item>
        <item>
          <key>dimeast</key>
          <value>TODO: implement this description</value>
        </item>
        <item>
          <key>dimsouth</key>
          <value>TODO: implement this description</value>
        </item>
        <item>
          <key>dimwest</key>
          <value>TODO: implement this description</value>
        </item>
        <item>
          <key>brightnorth</key>
          <value>TODO: implement this description</value>
        </item>
        <item>
          <key>brighteast</key>
          <value>TODO: implement this description</value>
        </item>
        <item>
          <key>brightsouth</key>
          <value>TODO: implement this description</value>
        </item>
        <item>
          <key>brightwest</key>
          <value>TODO: implement this description</value>
        </item>
      </descriptions>
      <bloodTrail type="boolean">false</bloodTrail>
      <description type="script">
        PrintRoomDesc (False)
      </description>
      <exit name="North66" alias="north" to="defaultroom">
        <inherit name="northdirection" />
        <runscript />
        <script type="script">
          MoveAndFace (kitchen30, 0)
        </script>
      </exit>
    </object>
    <object name="kitchen32">
      <inherit name="editor_room" />
      <usedefaultprefix />
      <descriptions type="stringdictionary">
        <item>
          <key>darknorth</key>
          <value>You cannot see anything. You can feel a wall in front of you.</value>
        </item>
        <item>
          <key>darkeast</key>
          <value>You cannot see anything. </value>
        </item>
        <item>
          <key>darksouth</key>
          <value>You cannot see anything. You can feel a counter in front of you.</value>
        </item>
        <item>
          <key>darkwest</key>
          <value>You cannot see anything.  </value>
        </item>
        <item>
          <key>dimnorth</key>
          <value>There is a wall in front of you. You cannot see any blood on the ground.</value>
        </item>
        <item>
          <key>dimeast</key>
          <value>There is a counter south of you, and a wall north of you. You cannot see any blood on the ground.</value>
        </item>
        <item>
          <key>dimsouth</key>
          <value>There is a counter in front of you. You cannot see any blood on the ground.</value>
        </item>
        <item>
          <key>dimwest</key>
          <value>There is a counter south of you, and a wall north of you. You cannot see any blood on the ground.</value>
        </item>
        <item>
          <key>brightnorth</key>
          <value>There is a wall in front of you. You think you can see some blood on the ground to the west of you, but it is hard to tell.</value>
        </item>
        <item>
          <key>brighteast</key>
          <value>You cannot see the trail of blood from here. There is a dead end up ahead.</value>
        </item>
        <item>
          <key>brightsouth</key>
          <value>There is a counter in front of you, it is dirty, and crawling with bugs, but there is nothing of interest on it. You think you can see some blood on the ground a couple steps west of you, but it is hard to tell.</value>
        </item>
        <item>
          <key>brightwest</key>
          <value>There is a wall north of you, and a counter south of you. You can see some blood on the ground a few steps forwards.</value>
        </item>
      </descriptions>
      <bloodTrail type="boolean">false</bloodTrail>
      <description type="script">
        PrintRoomDesc (False)
      </description>
      <exit name="East67" alias="east" to="defaultroom">
        <inherit name="eastdirection" />
        <runscript />
        <script type="script">
          MoveAndFace (kitchen24, 1)
        </script>
      </exit>
      <exit name="West67" alias="west" to="defaultroom">
        <inherit name="westdirection" />
        <runscript />
        <visible />
        <script type="script">
          MoveAndFace (kitchen34, 3)
        </script>
      </exit>
    </object>
    <object name="kitchen33">
      <inherit name="editor_room" />
      <usedefaultprefix />
      <descriptions type="stringdictionary">
        <item>
          <key>darknorth</key>
          <value>You cannot see anything. You feel a counter in front of you, and you bump it slightly fumbling in the darkness. You hear a quiet clang, you dont think anything heard it, thankfully. </value>
        </item>
        <item>
          <key>darkeast</key>
          <value>You cannot see anything. </value>
        </item>
        <item>
          <key>darksouth</key>
          <value>You cannot see anything. You can feel a counter in front of you, it is covered in something slimy and pungent.</value>
        </item>
        <item>
          <key>darkwest</key>
          <value>You cannot see anything. </value>
        </item>
        <item>
          <key>dimnorth</key>
          <value>There is a counter in front of you. There are some spots of blood on the ground.</value>
        </item>
        <item>
          <key>dimeast</key>
          <value>There are counters both to the north, and to the south of you. There are some spots of blood on the ground.</value>
        </item>
        <item>
          <key>dimsouth</key>
          <value>There is a counter in front of you, it is covered in rotting meat and maggots. There are some spots of blood on the ground.</value>
        </item>
        <item>
          <key>dimwest</key>
          <value>There is a counter north of you, and a counter south of you. There are some spots of blood on the ground.</value>
        </item>
        <item>
          <key>brightnorth</key>
          <value>There is a counter in front of you. The trail of blood breaks off west of you.</value>
        </item>
        <item>
          <key>brighteast</key>
          <value>There are counters both to the north and to the south of you. The trail of blood continues eastward in front of you.</value>
        </item>
        <item>
          <key>brightsouth</key>
          <value>There is a counter in front of you, it is covered in rotting meant and maggots, but nothing useful. The trail of blood breaks off to the west of you.</value>
        </item>
        <item>
          <key>brightwest</key>
          <value>There is a counter north of you, and a counter south of you. The trail of blood breaks off in front of you.</value>
        </item>
      </descriptions>
      <bloodTrail />
      <description type="script">
        PrintRoomDesc (False)
      </description>
      <exit name="East68" alias="east" to="defaultroom">
        <inherit name="eastdirection" />
        <runscript />
        <script type="script">
          MoveAndFace (kitchen28, 1)
        </script>
      </exit>
      <exit name="West68" alias="west" to="defaultroom">
        <inherit name="westdirection" />
        <runscript />
        <visible />
        <script type="script">
          MoveAndFace (kitchen40, 3)
        </script>
      </exit>
      <object name="pots">
        <inherit name="editor_object" />
        <alt type="stringlist">
          <value>pans</value>
          <value>pots and pans</value>
        </alt>
        <gender>they</gender>
        <article>they</article>
        <displayverbs type="stringlist">
          <value>Look at</value>
        </displayverbs>
        <fixed type="boolean">false</fixed>
        <drop type="boolean">false</drop>
        <feature_usegive />
        <visible />
        <scenery />
        <fix type="script">
          msg ("You quietly and painstakingly rearrange the pots and pans. They seem stable now.")
          pots.fixed = True
        </fix>
        <use type="script">
          msg ("You quietly and painstakingly rearrange the pots and pans. They seem stable now.")
          pots.fixed = True
        </use>
        <move type="script">
          msg ("You quietly and painstakingly rearrange the pots and pans. They seem stable now.")
          pots.fixed = True
        </move>
      </object>
      <turnscript name="pots_script">
        <enabled />
        <script><![CDATA[
          if (not pots.fixed) {
            if (Got(lantern)) {
              if (lantern.light_level = 1) {
                if (player.facing_num = 0) {
                  msg ("The counter in front of you is piled high with pots and pans. They look like they might fall at any second.")
                }
                else if (player.facing_num <> 2) {
                  msg ("The counter to the north is piled high with pots and pans. They look like they might fall at any second.")
                }
              }
              else if (lantern.light_level = 2) {
                if (player.facing_num = 0) {
                  msg ("The counter in front of you is piled high with pots and pans. They look like they might fall at any second. You might be able to fix them without making too much noise.")
                }
                else if (player.facing_num <> 2) {
                  msg ("The counter to the north is piled high with pots and pans. They look like they might fall at any second. You might be able to fix them without making too much noise.")
                }
              }
            }
          }
        ]]></script>
      </turnscript>
    </object>
    <object name="kitchen34">
      <inherit name="editor_room" />
      <usedefaultprefix />
      <descriptions type="stringdictionary">
        <item>
          <key>darknorth</key>
          <value>You cannot see anything. You can feel a wall in front of you.</value>
        </item>
        <item>
          <key>darkeast</key>
          <value>You cannot see anything. </value>
        </item>
        <item>
          <key>darksouth</key>
          <value>You cannot see anything. </value>
        </item>
        <item>
          <key>darkwest</key>
          <value>You cannot see anything. </value>
        </item>
        <item>
          <key>dimnorth</key>
          <value>There is a wall in front of you. You cannot see any blood on the ground.</value>
        </item>
        <item>
          <key>dimeast</key>
          <value>There is a wall on your north-side. You cannot see any blood on the ground.</value>
        </item>
        <item>
          <key>dimsouth</key>
          <value>You cannot see any blood on the ground.</value>
        </item>
        <item>
          <key>dimwest</key>
          <value>You cannot see any blood on the ground. </value>
        </item>
        <item>
          <key>brightnorth</key>
          <value>There is a wall in front of you. You can some spots of blood on the ground one step west.</value>
        </item>
        <item>
          <key>brighteast</key>
          <value>There is a wall on your north-side. You cannot see the blood trail from here. Up ahead is a dead end.</value>
        </item>
        <item>
          <key>brightsouth</key>
          <value>You can see some blood on the ground a few steps ahead, and a step west of you. </value>
        </item>
        <item>
          <key>brightwest</key>
          <value>You can see a trail of blood one step in front of you, leading west.</value>
        </item>
      </descriptions>
      <bloodTrail type="boolean">false</bloodTrail>
      <description type="script">
        PrintRoomDesc (False)
      </description>
      <exit name="East69" alias="east" to="defaultroom">
        <inherit name="eastdirection" />
        <runscript />
        <script type="script">
          MoveAndFace (kitchen32, 1)
        </script>
      </exit>
      <exit name="South69" alias="south" to="defaultroom">
        <inherit name="southdirection" />
        <runscript />
        <script type="script">
          MoveAndFace (kitchen35, 2)
        </script>
      </exit>
      <exit name="West69" alias="west" to="defaultroom">
        <inherit name="westdirection" />
        <runscript />
        <visible />
        <script type="script">
          MoveAndFace (kitchen44, 3)
        </script>
      </exit>
    </object>
    <object name="kitchen35">
      <inherit name="editor_room" />
      <usedefaultprefix />
      <descriptions type="stringdictionary">
        <item>
          <key>darknorth</key>
          <value>You cannot see anything. </value>
        </item>
        <item>
          <key>darkeast</key>
          <value>You cannot see anything. You can feel a counter in front of you.</value>
        </item>
        <item>
          <key>darksouth</key>
          <value>You cannot see anything. </value>
        </item>
        <item>
          <key>darkwest</key>
          <value>You cannot see anything. You can feel a counter in front of you. </value>
        </item>
        <item>
          <key>dimnorth</key>
          <value>There is a counter to the east, and to the west of you. You cannot see any blood on the ground.</value>
        </item>
        <item>
          <key>dimeast</key>
          <value>There is a counter in front of you. You cannot see any blood on the ground.</value>
        </item>
        <item>
          <key>dimsouth</key>
          <value>There is a counter to the east, and to the west of you. You cannot see any blood on the ground.</value>
        </item>
        <item>
          <key>dimwest</key>
          <value>There is a counter in front of you. You cannot see any blood on the ground.</value>
        </item>
        <item>
          <key>brightnorth</key>
          <value>There is a counter to the east, and to the west of you. You cannot see the blood trail from here.</value>
        </item>
        <item>
          <key>brighteast</key>
          <value>There is a counter in front of you. You can see some blood on the ground to the south of you.</value>
        </item>
        <item>
          <key>brightsouth</key>
          <value>There is a counter to the east, and to the west of you. There is blood on the ground a step in front of you.</value>
        </item>
        <item>
          <key>brightwest</key>
          <value>There is a counter in front of you. You can see blood on the ground a step to the south.</value>
        </item>
        <item>
          <key>notes</key>
          <value>Interaction trap space.</value>
        </item>
      </descriptions>
      <bloodTrail type="boolean">false</bloodTrail>
      <description type="script">
        if (dishes.fixed = True) {
          PrintRoomDesc (False)
        }
        else {
          msg ("As you are making your way through the narrow space between counters, you accidently smack your hip on the countertop. A plate comes crashing down on the ground.")
          msg ("The crash is suddenly followed by a loud rumble, grunting, and heavy feet stomping closer and closer to you. You try to make yourself as small as possible, hiding by pressing yourself down against the counter.")
          msg ("You can hear the creature inhale deeply, and then it is as if he could smell you. He knows exactly where you are. You close your eyes, you hear his stomps stop in front of you. You take a deep breath. It smells of pungent rotting meat. You hear movement, and a rush of air. And then...")
          Die
        }
      </description>
      <exit name="North70" alias="north" to="defaultroom">
        <inherit name="northdirection" />
        <runscript />
        <script type="script">
          MoveAndFace (kitchen34, 0)
        </script>
      </exit>
      <exit name="South70" alias="south" to="defaultroom">
        <inherit name="southdirection" />
        <runscript />
        <script type="script">
          MoveAndFace (kitchen36, 2)
        </script>
      </exit>
    </object>
    <object name="kitchen36">
      <inherit name="editor_room" />
      <usedefaultprefix />
      <descriptions type="stringdictionary">
        <item>
          <key>darknorth</key>
          <value>You cannot see anything. </value>
        </item>
        <item>
          <key>darkeast</key>
          <value>You cannot see anything. You feel a counter in front of you. </value>
        </item>
        <item>
          <key>darksouth</key>
          <value>You cannot see anything.  </value>
        </item>
        <item>
          <key>darkwest</key>
          <value>You cannot see anything.  You can feel a counter in front of you. </value>
        </item>
        <item>
          <key>dimnorth</key>
          <value>There is a counter to the west of you, and to the east of you. There are some spots of blood on the ground.</value>
        </item>
        <item>
          <key>dimeast</key>
          <value>There is a counter in front of you. There are some spots of blood on the ground.</value>
        </item>
        <item>
          <key>dimsouth</key>
          <value>There is a counter to the east of you, and to the west of you. There are some spots of blood on the ground. </value>
        </item>
        <item>
          <key>dimwest</key>
          <value>There is a counter in front of you. There is a pile of dirty, bug infested dishes on it. They look like they might fall at any second. There are some spots of blood on the ground.</value>
        </item>
        <item>
          <key>brightnorth</key>
          <value>There is a counter to the west of you, and to the east of you. The trail of blood on the ground breaks off in front of you.</value>
        </item>
        <item>
          <key>brighteast</key>
          <value>There is a counter in front of you. The trail of blood breaks off a step to the north of you, and carries on to the south of you.</value>
        </item>
        <item>
          <key>brightsouth</key>
          <value>There is a counter to the east of you, and to the west of you. The trail of blood on the ground continues in front of you.</value>
        </item>
        <item>
          <key>brightwest</key>
          <value>There is a counter in front of you. There is a pile of dirty, bug infested dishes on it. They look like they might fall at any second. You might be able to fix it without making too much noise.</value>
        </item>
      </descriptions>
      <bloodTrail />
      <description type="script"><![CDATA[
        PrintRoomDesc (False)
        if (not dishes.fixed) {
          if (Got(lantern)) {
            if (lantern.light_level = 1) {
              if (player.facing_num = 3) {
                msg ("The counter in front of you has a pile of dirty, bug infested, dishes on it. They look like they might fall at any second.")
              }
              else if (player.facing_num <> 1) {
                msg ("The counter to the west has a pile of dirty, bug infested, dishes on it. They look like they might fall at any second.")
              }
            }
            else if (lantern.light_level = 2) {
              if (player.facing_num = 3) {
                msg ("The counter in front of you has a pile of dirty, bug infested, dishes on it. They look like they might fall at any second. You might be able to fix them without making too much noise.")
              }
              else if (player.facing_num <> 1) {
                msg ("The counter to the west has a pile of dirty, bug infested, dishes on it. They look like they might fall at any second. You might be able to fix them without making too much noise.")
              }
            }
          }
        }
      ]]></description>
      <enter type="script">
      </enter>
      <beforeenter type="script">
      </beforeenter>
      <exit name="North71" alias="north" to="defaultroom">
        <inherit name="northdirection" />
        <runscript />
        <script type="script">
          MoveAndFace (kitchen35, 0)
        </script>
      </exit>
      <exit name="South71" alias="south" to="defaultroom">
        <inherit name="southdirection" />
        <runscript />
        <script type="script">
          MoveAndFace (kitchen37, 2)
        </script>
      </exit>
      <object name="dishes">
        <inherit name="editor_object" />
        <alt type="stringlist">
          <value>plates</value>
        </alt>
        <gender>they</gender>
        <article>they</article>
        <displayverbs type="stringlist">
          <value>Look at</value>
        </displayverbs>
        <fixed type="boolean">false</fixed>
        <drop type="boolean">false</drop>
        <feature_usegive />
        <visible />
        <scenery />
        <fix type="script">
          msg ("You carefully nudge the dishes into a steadier position. They seem stable now.")
          dishes.fixed = True
        </fix>
        <use type="script">
          msg ("You carefully nudge the dishes into a steadier position. They seem stable now.")
          dishes.fixed = True
        </use>
        <move type="script">
          msg ("You carefully nudge the dishes into a steadier position. They seem stable now.")
          dishes.fixed = True
        </move>
      </object>
    </object>
    <object name="kitchen37">
      <inherit name="editor_room" />
      <usedefaultprefix />
      <descriptions type="stringdictionary">
        <item>
          <key>darknorth</key>
          <value>You cannot see anything. </value>
        </item>
        <item>
          <key>darkeast</key>
          <value>You cannot see anything. You can feel a counter in front of you. </value>
        </item>
        <item>
          <key>darksouth</key>
          <value>You cannot see anything. </value>
        </item>
        <item>
          <key>darkwest</key>
          <value>You cannot see anything. There is a counter in front of you.</value>
        </item>
        <item>
          <key>dimnorth</key>
          <value>There is a counter to the east, and to the west of you. There are some spots of blood on the ground.</value>
        </item>
        <item>
          <key>dimeast</key>
          <value>There is a counter in front of you. There are some spots of blood on the ground.</value>
        </item>
        <item>
          <key>dimsouth</key>
          <value>There is a counter to the east, and to the west of you. There are some spots of blood on the ground.</value>
        </item>
        <item>
          <key>dimwest</key>
          <value>There is a counter in front of you. There are some spots of blood on the ground. </value>
        </item>
        <item>
          <key>brightnorth</key>
          <value>There is a counter to the east, and to the west of you. The trail of blood continues in front of you. </value>
        </item>
        <item>
          <key>brighteast</key>
          <value>There is a counter in front of you. There is a trail of blood on the ground that continues northwards, and southwards.</value>
        </item>
        <item>
          <key>brightsouth</key>
          <value>There is a counter to the east, and to the west of you. There is a trail of blood on the ground that continues forwards.</value>
        </item>
        <item>
          <key>brightwest</key>
          <value>There is a counter in front of you. There is trail of blood on the ground that continues northwards, and southwards.</value>
        </item>
      </descriptions>
      <bloodTrail />
      <description type="script"><![CDATA[
        PrintRoomDesc (False)
        if (Got(lantern) and lantern.light_level > 0 and not oil1.parent = null and lantern.light_level > 0) {
          if (player.facing_num = 1) {
            msg ("The counter in front of you has a cask of oil sitting on it.")
          }
          else if (player.facing_num <> 3) {
            msg ("The counter to the east has a cask of oil sitting on it.")
          }
        }
      ]]></description>
      <exit name="North72" alias="north" to="defaultroom">
        <inherit name="northdirection" />
        <runscript />
        <script type="script">
          MoveAndFace (kitchen36, 0)
        </script>
      </exit>
      <exit name="South72" alias="south" to="defaultroom">
        <inherit name="southdirection" />
        <runscript />
        <script type="script">
          MoveAndFace (kitchen38, 2)
        </script>
      </exit>
      <object name="oil1">
        <inherit name="editor_object" />
        <alt type="stringlist">
          <value>cask</value>
        </alt>
        <alias>oil</alias>
        <scenery />
        <feature_usegive />
        <take type="script">
          GetOil (oil1)
        </take>
        <use type="script">
          GetOil (oil1)
        </use>
      </object>
    </object>
    <object name="kitchen38">
      <inherit name="editor_room" />
      <usedefaultprefix />
      <descriptions type="stringdictionary">
        <item>
          <key>darknorth</key>
          <value>You cannot see anything. </value>
        </item>
        <item>
          <key>darkeast</key>
          <value>You cannot see anything. You can feel a counter in front of you.</value>
        </item>
        <item>
          <key>darksouth</key>
          <value>You cannot see anything. </value>
        </item>
        <item>
          <key>darkwest</key>
          <value>You cannot see anything. You can feel a counter in front of you. </value>
        </item>
        <item>
          <key>dimnorth</key>
          <value>There is a counter to the east, and to the west of you. There are some spots of blood on the ground.</value>
        </item>
        <item>
          <key>dimeast</key>
          <value>There is a counter in front of you. There are some spots of blood on the ground.</value>
        </item>
        <item>
          <key>dimsouth</key>
          <value>There is a counter to the east, and to the west of you. There are some spots of blood on the ground.</value>
        </item>
        <item>
          <key>dimwest</key>
          <value>There is a counter in front of you. There are some spots of blood on the ground.</value>
        </item>
        <item>
          <key>brightnorth</key>
          <value>There is a counter to the east, and to the west of you. There is a trail of blood on the ground leading forwards.</value>
        </item>
        <item>
          <key>brighteast</key>
          <value>There is a counter in front of you. There is a trail of blood on the ground, leading northwards.</value>
        </item>
        <item>
          <key>brightsouth</key>
          <value>There is a counter to the east, and to the west of you. There is a trail of blood on the ground that breaks off in front of you.</value>
        </item>
        <item>
          <key>brightwest</key>
          <value>There is a counter in front of you. There is a trail of blood on the ground, leading northwards.</value>
        </item>
      </descriptions>
      <bloodTrail />
      <description type="script">
        PrintRoomDesc (False)
      </description>
      <exit name="North73" alias="north" to="defaultroom">
        <inherit name="northdirection" />
        <runscript />
        <script type="script">
          MoveAndFace (kitchen37, 0)
        </script>
      </exit>
      <exit name="South73" alias="south" to="defaultroom">
        <inherit name="southdirection" />
        <runscript />
        <script type="script">
          MoveAndFace (kitchen39, 2)
        </script>
      </exit>
    </object>
    <object name="kitchen39">
      <inherit name="editor_room" />
      <usedefaultprefix />
      <descriptions type="stringdictionary">
        <item>
          <key>darknorth</key>
          <value>You cannot see anything. </value>
        </item>
        <item>
          <key>darkeast</key>
          <value>You cannot see anything. You can feel a counter in front of you. </value>
        </item>
        <item>
          <key>darksouth</key>
          <value>You cannot see anything. </value>
        </item>
        <item>
          <key>darkwest</key>
          <value>You cannot see anything. You can feel a counter in front of you.  </value>
        </item>
        <item>
          <key>dimnorth</key>
          <value>There is a counter to the east, and to the west of you. There are some spots of blood on the ground.</value>
        </item>
        <item>
          <key>dimeast</key>
          <value>There is a counter in front of you. There are some spots of blood on the ground.</value>
        </item>
        <item>
          <key>dimsouth</key>
          <value>There is a counter to the east, and to the west of you. There are some spots of blood on the ground.</value>
        </item>
        <item>
          <key>dimwest</key>
          <value>There is a counter in front of you. There are some spots of blood on the ground.</value>
        </item>
        <item>
          <key>brightnorth</key>
          <value>There is a counter to the east, and to the west of you. There is a trail of blood on the ground leading forwards. </value>
        </item>
        <item>
          <key>brighteast</key>
          <value>There is a counter in front of you. There is a trail of blood on the ground leading northwards, it breaks off to the south of you.</value>
        </item>
        <item>
          <key>brightsouth</key>
          <value>There is a counter to the east, and to the west of you. There is a trail of blood on the ground that breaks off in front of you.</value>
        </item>
        <item>
          <key>brightwest</key>
          <value>There is a counter in front of you. There is a trail of blood on the ground that continues northwards, but breaks off southwards.</value>
        </item>
      </descriptions>
      <bloodTrail />
      <description type="script">
        if (pots.fixed) {
          PrintRoomDesc (False)
        }
        else {
          msg ("Your lantern catches on a jutting pot handle, bringing the entire pile of cookware cacophonously to the ground and extinguishing your lantern. You hear grunts, and stomping coming closer to you. You hold your breath...")
          msg ("It stops and goes back to wherever it came from. You breathe a sigh of relief and pick up your lantern.")
          JumpScare
          lantern.light_level = 0
        }
      </description>
      <exit name="North74" alias="north" to="defaultroom">
        <inherit name="northdirection" />
        <runscript />
        <script type="script">
          MoveAndFace (kitchen38, 0)
        </script>
      </exit>
      <exit name="South74" alias="south" to="defaultroom">
        <inherit name="southdirection" />
        <runscript />
        <script type="script">
          MoveAndFace (kitchen40, 2)
        </script>
      </exit>
    </object>
    <object name="kitchen40">
      <inherit name="editor_room" />
      <usedefaultprefix />
      <descriptions type="stringdictionary">
        <item>
          <key>darknorth</key>
          <value>You cannot see anything. </value>
        </item>
        <item>
          <key>darkeast</key>
          <value>You cannot see anything. </value>
        </item>
        <item>
          <key>darksouth</key>
          <value>You cannot see anything. </value>
        </item>
        <item>
          <key>darkwest</key>
          <value>You cannot see anything. </value>
        </item>
        <item>
          <key>dimnorth</key>
          <value>You cannot see any blood on the ground. </value>
        </item>
        <item>
          <key>dimeast</key>
          <value>You cannot see any blood on the ground.</value>
        </item>
        <item>
          <key>dimsouth</key>
          <value>You cannot see any blood on the ground.</value>
        </item>
        <item>
          <key>dimwest</key>
          <value>You cannot see any blood on the ground. The ground in front of you looks a little weird.</value>
        </item>
        <item>
          <key>brightnorth</key>
          <value>There is some blood on the ground a step forwards.</value>
        </item>
        <item>
          <key>brighteast</key>
          <value>There is some blood on the ground a step forwards.</value>
        </item>
        <item>
          <key>brightsouth</key>
          <value>There is some blood on the ground a step east of you. The floor to the west of you looks unstable. </value>
        </item>
        <item>
          <key>brightwest</key>
          <value>There is some blood on the ground a step northwards. The floor a step in front of you looks unstable. </value>
        </item>
      </descriptions>
      <bloodTrail type="boolean">false</bloodTrail>
      <description type="script">
        PrintRoomDesc (False)
      </description>
      <exit name="North75" alias="north" to="defaultroom">
        <inherit name="northdirection" />
        <runscript />
        <script type="script">
          MoveAndFace (kitchen39, 0)
        </script>
      </exit>
      <exit name="East75" alias="east" to="defaultroom">
        <inherit name="eastdirection" />
        <runscript />
        <script type="script">
          MoveAndFace (kitchen33, 1)
        </script>
      </exit>
      <exit name="South75" alias="south" to="defaultroom">
        <inherit name="southdirection" />
        <runscript />
        <script type="script">
          MoveAndFace (kitchen41, 2)
        </script>
      </exit>
      <exit name="West75" alias="west" to="defaultroom">
        <inherit name="westdirection" />
        <runscript />
        <visible />
        <script type="script">
          msg ("Your foot gets caught in something, and you fall to the ground. You try to brace your fall, but only end up letting go of the lantern, which rolls away from you. You seem to have tripped on an old wooden trap door. It is rotting away, and has a large hole in it where your foot once was. You get back up, and pick up your lantern that is now unlit.")
          JumpScare
          lantern.light_level = 0
        </script>
      </exit>
    </object>
    <object name="kitchen41">
      <inherit name="editor_room" />
      <usedefaultprefix />
      <descriptions type="stringdictionary">
        <item>
          <key>darknorth</key>
          <value>You cannot see anything. </value>
        </item>
        <item>
          <key>darkeast</key>
          <value>You cannot see anything. You can feel a counter in front of you.</value>
        </item>
        <item>
          <key>darksouth</key>
          <value>You cannot see anything. </value>
        </item>
        <item>
          <key>darkwest</key>
          <value>You cannot see anything. You can feel a counter in front of you.</value>
        </item>
        <item>
          <key>dimnorth</key>
          <value>There is a counter to the east, and to the west of you. You cannot see any blood on the ground.</value>
        </item>
        <item>
          <key>dimeast</key>
          <value>There is a counter in front of you. You cannot see any blood on the ground.</value>
        </item>
        <item>
          <key>dimsouth</key>
          <value>There is a counter to the east, and to the west of you. You cannot see any blood on the ground.</value>
        </item>
        <item>
          <key>dimwest</key>
          <value>There is a counter in front of you. You cannot see any blood on the ground.</value>
        </item>
        <item>
          <key>brightnorth</key>
          <value>There is a counter to the east, and to the west of you. You think you can see some blood up ahead a few steps, but it is hard to tell. </value>
        </item>
        <item>
          <key>brighteast</key>
          <value>There is a counter in front of you. You cannot see the trail of blood from here.</value>
        </item>
        <item>
          <key>brightsouth</key>
          <value>There is a counter to the east, and to the west of you. There is a dead end up ahead a few steps. You cannot see the blood trail from here.  </value>
        </item>
        <item>
          <key>brightwest</key>
          <value>There is a counter in front of you. You cannot see the trail of blood from here.</value>
        </item>
      </descriptions>
      <bloodTrail type="boolean">false</bloodTrail>
      <description type="script">
        PrintRoomDesc (False)
      </description>
      <exit name="North76" alias="north" to="defaultroom">
        <inherit name="northdirection" />
        <runscript />
        <script type="script">
          MoveAndFace (kitchen40, 0)
        </script>
      </exit>
      <exit name="South76" alias="south" to="defaultroom">
        <inherit name="southdirection" />
        <runscript />
        <script type="script">
          MoveAndFace (kitchen42, 2)
        </script>
      </exit>
    </object>
    <object name="kitchen42">
      <inherit name="editor_room" />
      <usedefaultprefix />
      <descriptions type="stringdictionary">
        <item>
          <key>darknorth</key>
          <value>You cannot see anything. </value>
        </item>
        <item>
          <key>darkeast</key>
          <value>You cannot see anything. You can feel a counter in front of you.</value>
        </item>
        <item>
          <key>darksouth</key>
          <value>You cannot see anything. </value>
        </item>
        <item>
          <key>darkwest</key>
          <value>You cannot see anything. You can feel a counter in front of you. </value>
        </item>
        <item>
          <key>dimnorth</key>
          <value>There is a counter to the east, and to the west of you. You cannot see any blood on the ground.</value>
        </item>
        <item>
          <key>dimeast</key>
          <value>There is a counter in front of you. You cannot see any blood on the ground.</value>
        </item>
        <item>
          <key>dimsouth</key>
          <value>There is a counter to the east, and to the west of you. You cannot see any blood on the ground.</value>
        </item>
        <item>
          <key>dimwest</key>
          <value>There is a counter in front of you. You cannot see any blood on the ground.</value>
        </item>
        <item>
          <key>brightnorth</key>
          <value>There is a counter to the east, and to the west of you. You cannot see the trail of blood from here.</value>
        </item>
        <item>
          <key>brighteast</key>
          <value>There is a counter in front of you. There is a dead end to the south of you. You cannot see the trail of blood from here.</value>
        </item>
        <item>
          <key>brightsouth</key>
          <value>There is a counter to the east, and to the west of you. There is a dead end up ahead. </value>
        </item>
        <item>
          <key>brightwest</key>
          <value>There is a counter in front of you. There is a dead end to the south of you. You cannot see the trail of blood from here.</value>
        </item>
      </descriptions>
      <bloodTrail type="boolean">false</bloodTrail>
      <description type="script">
        PrintRoomDesc (False)
      </description>
      <exit name="North77" alias="north" to="defaultroom">
        <inherit name="northdirection" />
        <runscript />
        <script type="script">
          MoveAndFace (kitchen41, 0)
        </script>
      </exit>
      <exit name="South77" alias="south" to="defaultroom">
        <inherit name="southdirection" />
        <runscript />
        <script type="script">
          MoveAndFace (kitchen43, 2)
        </script>
      </exit>
    </object>
    <object name="kitchen43">
      <inherit name="editor_room" />
      <usedefaultprefix />
      <descriptions type="stringdictionary">
        <item>
          <key>darknorth</key>
          <value>You cannot see anything.</value>
        </item>
        <item>
          <key>darkeast</key>
          <value>You cannot see anything. You can feel a counter in front of you.</value>
        </item>
        <item>
          <key>darksouth</key>
          <value>You cannot see anything.</value>
        </item>
        <item>
          <key>darkwest</key>
          <value>You cannot see anything. You can feel a counter in front of you. </value>
        </item>
        <item>
          <key>dimnorth</key>
          <value>There are counters to the east and to the west of you. You cannot see any blood on the ground.</value>
        </item>
        <item>
          <key>dimeast</key>
          <value>There is a counter in front of you, and a wall to the south. You cannot see any blood on the ground.</value>
        </item>
        <item>
          <key>dimsouth</key>
          <value>There is a wall in front of you, and counters to the east and to the west of you. You cannot see any blood on the ground.</value>
        </item>
        <item>
          <key>dimwest</key>
          <value>There is a counter in front of you, and a wall to the south. You cannot see any blood on the ground.</value>
        </item>
        <item>
          <key>brightnorth</key>
          <value>There are counters to the east and to the west of you. You cannot see the trail of blood from here.</value>
        </item>
        <item>
          <key>brighteast</key>
          <value>There is a counter in front of you, and a wall to the south. You cannot see the trail of blood from here.</value>
        </item>
        <item>
          <key>brightsouth</key>
          <value>There is a wall in front of you, and counters to the east and to the west of you. You cannot see the trail of blood from here.</value>
        </item>
        <item>
          <key>brightwest</key>
          <value>There is a counter in front of you, and a wall to the south. You cannot see the trail of blood from here.</value>
        </item>
      </descriptions>
      <bloodTrail type="boolean">false</bloodTrail>
      <description type="script">
        PrintRoomDesc (False)
      </description>
      <exit name="North78" alias="north" to="defaultroom">
        <inherit name="northdirection" />
        <runscript />
        <script type="script">
          MoveAndFace (kitchen42, 0)
        </script>
      </exit>
    </object>
    <object name="kitchen44">
      <inherit name="editor_room" />
      <usedefaultprefix />
      <descriptions type="stringdictionary">
        <item>
          <key>darknorth</key>
          <value>You cannot see anything. You can feel a wall in front of you. </value>
        </item>
        <item>
          <key>darkeast</key>
          <value>You cannot see anything. </value>
        </item>
        <item>
          <key>darksouth</key>
          <value>You cannot see anything. You feel a counter in front of you. </value>
        </item>
        <item>
          <key>darkwest</key>
          <value>You cannot see anything. </value>
        </item>
        <item>
          <key>dimnorth</key>
          <value>There is a wall in front of you. There are some spots of blood on the ground.</value>
        </item>
        <item>
          <key>dimeast</key>
          <value>There is a wall to the north of you, and a counter to the south. There are some spots of blood on the ground.</value>
        </item>
        <item>
          <key>dimsouth</key>
          <value>There is a counter in front of you. There are some spots blood on the ground.</value>
        </item>
        <item>
          <key>dimwest</key>
          <value>There is a counter to the south of you, and a wall to the north. There are some spots of blood on the ground.</value>
        </item>
        <item>
          <key>brightnorth</key>
          <value>There is a wall in front of you. The trail of blood continues westward.</value>
        </item>
        <item>
          <key>brighteast</key>
          <value>There is a wall to the north of you, and a counter to the south. The trail of blood breaks off in front of you.</value>
        </item>
        <item>
          <key>brightsouth</key>
          <value>There is a counter in front of you. There is a trail of blood on the ground leading west.</value>
        </item>
        <item>
          <key>brightwest</key>
          <value>There is a counter to the south of you, and a wall to the north. There is a trail of blood on the ground leading forwards.</value>
        </item>
      </descriptions>
      <bloodTrail />
      <description type="script">
        PrintRoomDesc (False)
      </description>
      <exit name="East79" alias="east" to="defaultroom">
        <inherit name="eastdirection" />
        <runscript />
        <script type="script">
          MoveAndFace (kitchen34, 1)
        </script>
      </exit>
      <exit name="West79" alias="west" to="defaultroom">
        <inherit name="westdirection" />
        <runscript />
        <visible />
        <script type="script">
          MoveAndFace (kitchen46, 3)
        </script>
      </exit>
    </object>
    <object name="kitchen45">
      <inherit name="editor_room" />
      <usedefaultprefix />
      <descriptions type="stringdictionary">
        <item>
          <key>darknorth</key>
          <value>TODO: implement this description</value>
        </item>
        <item>
          <key>darkeast</key>
          <value>TODO: implement this description</value>
        </item>
        <item>
          <key>darksouth</key>
          <value>TODO: implement this description</value>
        </item>
        <item>
          <key>darkwest</key>
          <value>TODO: implement this description</value>
        </item>
        <item>
          <key>dimnorth</key>
          <value>TODO: implement this description</value>
        </item>
        <item>
          <key>dimeast</key>
          <value>TODO: implement this description</value>
        </item>
        <item>
          <key>dimsouth</key>
          <value>TODO: implement this description</value>
        </item>
        <item>
          <key>dimwest</key>
          <value>TODO: implement this description</value>
        </item>
        <item>
          <key>brightnorth</key>
          <value>TODO: implement this description</value>
        </item>
        <item>
          <key>brighteast</key>
          <value>TODO: implement this description</value>
        </item>
        <item>
          <key>brightsouth</key>
          <value>TODO: implement this description</value>
        </item>
        <item>
          <key>brightwest</key>
          <value>TODO: implement this description</value>
        </item>
      </descriptions>
      <bloodTrail type="boolean">false</bloodTrail>
      <description type="string"></description>
      <exit name="East80" alias="east" to="defaultroom">
        <inherit name="eastdirection" />
        <runscript />
        <script type="script">
          msg ("Your foot gets caught in something, and you fall to the ground. You try to brace your fall, but only end up letting go of the lantern, which rolls away from you. You seem to have tripped on an old wooden trap door. It is rotting away, and has a large hole in it where your foot once was. You get back up, and pick up your lantern that is now unlit.")
          JumpScare
          lantern.light_level = 0
        </script>
      </exit>
      <exit name="West80" alias="west" to="defaultroom">
        <inherit name="westdirection" />
        <runscript />
        <visible />
        <script type="script">
          MoveAndFace (kitchen52, 3)
        </script>
      </exit>
    </object>
    <object name="kitchen46">
      <inherit name="editor_room" />
      <usedefaultprefix />
      <descriptions type="stringdictionary">
        <item>
          <key>darknorth</key>
          <value>You cannot see anything. You can feel a wall in front of you.</value>
        </item>
        <item>
          <key>darkeast</key>
          <value>You cannot see anything. </value>
        </item>
        <item>
          <key>darksouth</key>
          <value>You cannot see anything. </value>
        </item>
        <item>
          <key>darkwest</key>
          <value>You cannot see anything. </value>
        </item>
        <item>
          <key>dimnorth</key>
          <value>There is a wall in front of you. There are some spots of blood on the ground.</value>
        </item>
        <item>
          <key>dimeast</key>
          <value>There is a wall to the north of you. There are some spots of blood on the ground.</value>
        </item>
        <item>
          <key>dimsouth</key>
          <value>There are some spots of blood on the ground.</value>
        </item>
        <item>
          <key>dimwest</key>
          <value>There is a wall to the north of you. There are some spots of blood on the ground. </value>
        </item>
        <item>
          <key>brightnorth</key>
          <value>There is a wall in front of you. There is a trail of blood on the ground leading both east, and west of you.</value>
        </item>
        <item>
          <key>brighteast</key>
          <value>There is a wall to the north of you. There is a trail of blood on the ground leading forwards.</value>
        </item>
        <item>
          <key>brightsouth</key>
          <value>There is a trail of blood leading both east, and west of you.</value>
        </item>
        <item>
          <key>brightwest</key>
          <value>There is a wall to the north of you. There is a trail of blood leading forwards.</value>
        </item>
      </descriptions>
      <bloodTrail />
      <description type="script">
        PrintRoomDesc (False)
      </description>
      <exit name="East81" alias="east" to="defaultroom">
        <inherit name="eastdirection" />
        <runscript />
        <script type="script">
          MoveAndFace (kitchen44, 1)
        </script>
      </exit>
      <exit name="South81" alias="south" to="defaultroom">
        <inherit name="southdirection" />
        <runscript />
        <script type="script">
          MoveAndFace (kitchen47, 2)
        </script>
      </exit>
      <exit name="West81" alias="west" to="defaultroom">
        <inherit name="westdirection" />
        <runscript />
        <visible />
        <script type="script">
          MoveAndFace (kitchen53, 3)
        </script>
      </exit>
    </object>
    <object name="kitchen47">
      <inherit name="editor_room" />
      <usedefaultprefix />
      <descriptions type="stringdictionary">
        <item>
          <key>darknorth</key>
          <value>You cannot see anything. </value>
        </item>
        <item>
          <key>darkeast</key>
          <value>You cannot see anything. You can feel a counter in front of you.  </value>
        </item>
        <item>
          <key>darksouth</key>
          <value>You cannot see anything. </value>
        </item>
        <item>
          <key>darkwest</key>
          <value>You cannot see anything. You can feel a counter in front of you.</value>
        </item>
        <item>
          <key>dimnorth</key>
          <value>There is a counter to the east, and to the west of you. You cannot see any blood on the ground. </value>
        </item>
        <item>
          <key>dimeast</key>
          <value>There is a counter in front of you. You cannot see any blood on the ground.</value>
        </item>
        <item>
          <key>dimsouth</key>
          <value>There is a counter to the east, and to the west of you. You cannot see any blood on the ground.</value>
        </item>
        <item>
          <key>dimwest</key>
          <value>There is a counter in a front of you. You cannot see any blood on the ground.</value>
        </item>
        <item>
          <key>brightnorth</key>
          <value>There is a counter to the east, and to the west of you. You can see some blood on the ground a step in front of you. </value>
        </item>
        <item>
          <key>brighteast</key>
          <value>There is a counter in front of you. You can see some blood on the ground a step north of you.</value>
        </item>
        <item>
          <key>brightsouth</key>
          <value>There is a counter to the east, and to the west of you. You cannot see the trail of blood from here. </value>
        </item>
        <item>
          <key>brightwest</key>
          <value>There is a counter in front of you. You can see some blood on the ground a step to the north of you.</value>
        </item>
      </descriptions>
      <bloodTrail type="boolean">false</bloodTrail>
      <description type="script">
        PrintRoomDesc (False)
      </description>
      <exit name="North82" alias="north" to="defaultroom">
        <inherit name="northdirection" />
        <runscript />
        <script type="script">
          MoveAndFace (kitchen46, 0)
        </script>
      </exit>
      <exit name="South82" alias="south" to="defaultroom">
        <inherit name="southdirection" />
        <runscript />
        <script type="script">
          MoveAndFace (kitchen48, 2)
        </script>
      </exit>
    </object>
    <object name="kitchen48">
      <inherit name="editor_room" />
      <usedefaultprefix />
      <descriptions type="stringdictionary">
        <item>
          <key>darknorth</key>
          <value>You cannot see anything. </value>
        </item>
        <item>
          <key>darkeast</key>
          <value>You cannot see anything. You can feel a counter in front of you.</value>
        </item>
        <item>
          <key>darksouth</key>
          <value>You cannot see anything. </value>
        </item>
        <item>
          <key>darkwest</key>
          <value>You cannot see anything. You can feel a counter in front of you.</value>
        </item>
        <item>
          <key>dimnorth</key>
          <value>There is a counter to the east, and to the west of you. You cannot see any blood on the ground.</value>
        </item>
        <item>
          <key>dimeast</key>
          <value>There is a counter in front of you. You cannot see any blood on the ground.</value>
        </item>
        <item>
          <key>dimsouth</key>
          <value>There is a counter to the east, and to the west of you. You cannot see any blood on the ground.</value>
        </item>
        <item>
          <key>dimwest</key>
          <value>There is a counter in front of you. You cannot see any blood on the ground.</value>
        </item>
        <item>
          <key>brightnorth</key>
          <value>There is a counter to the east, and to the west of you. You can see some blood on the ground a few steps ahead. </value>
        </item>
        <item>
          <key>brighteast</key>
          <value>There is a counter in front of you. You can see some blood on the ground a few steps north of you.</value>
        </item>
        <item>
          <key>brightsouth</key>
          <value>There is a counter to the east, and to the west of you. You cannot see the trail of blood from here. </value>
        </item>
        <item>
          <key>brightwest</key>
          <value>There is a counter in front of you. You can see some blood on the ground a few steps north of you.</value>
        </item>
      </descriptions>
      <bloodTrail type="boolean">false</bloodTrail>
      <description type="script">
        PrintRoomDesc (False)
      </description>
      <exit name="North83" alias="north" to="defaultroom">
        <inherit name="northdirection" />
        <runscript />
        <script type="script">
          MoveAndFace (kitchen47, 0)
        </script>
      </exit>
      <exit name="South83" alias="south" to="defaultroom">
        <inherit name="southdirection" />
        <runscript />
        <script type="script">
          MoveAndFace (kitchen49, 2)
        </script>
      </exit>
    </object>
    <object name="kitchen49">
      <inherit name="editor_room" />
      <usedefaultprefix />
      <descriptions type="stringdictionary">
        <item>
          <key>darknorth</key>
          <value>You cannot see anything. </value>
        </item>
        <item>
          <key>darkeast</key>
          <value>You cannot see anything. You can feel a counter in front of you</value>
        </item>
        <item>
          <key>darksouth</key>
          <value>You cannot see anything. </value>
        </item>
        <item>
          <key>darkwest</key>
          <value>You cannot see anything. You can feel a counter in front of you.</value>
        </item>
        <item>
          <key>dimnorth</key>
          <value>There is a counter to the east, and to the west of you. You cannot see any blood on the ground.</value>
        </item>
        <item>
          <key>dimeast</key>
          <value>There is a counter in front of you. You cannot see any blood on the ground.</value>
        </item>
        <item>
          <key>dimsouth</key>
          <value>There is a counter to the east, and to the west of you. You cannot see any blood on the ground.</value>
        </item>
        <item>
          <key>dimwest</key>
          <value>There is a counter in front of you. You cannot see any blood on the ground.</value>
        </item>
        <item>
          <key>brightnorth</key>
          <value>There is a counter to the east, and to the west of you. You think you can see some blood on the ground a few steps ahead, but its hard to tell.</value>
        </item>
        <item>
          <key>brighteast</key>
          <value>There is a counter in front of you. You cannot see the trail of blood from here.</value>
        </item>
        <item>
          <key>brightsouth</key>
          <value>There is a counter to the east, and to the west of you. You cannot see the trail of blood from here.</value>
        </item>
        <item>
          <key>brightwest</key>
          <value>There is a counter in front of you. You cannot see the trail of blood from here.</value>
        </item>
      </descriptions>
      <bloodTrail type="boolean">false</bloodTrail>
      <description type="script">
        PrintRoomDesc (False)
      </description>
      <exit name="North84" alias="north" to="defaultroom">
        <inherit name="northdirection" />
        <runscript />
        <script type="script">
          MoveAndFace (kitchen48, 0)
        </script>
      </exit>
      <exit name="South84" alias="south" to="defaultroom">
        <inherit name="southdirection" />
        <runscript />
        <script type="script">
          MoveAndFace (kitchen50, 2)
        </script>
      </exit>
    </object>
    <object name="kitchen50">
      <inherit name="editor_room" />
      <usedefaultprefix />
      <descriptions type="stringdictionary">
        <item>
          <key>darknorth</key>
          <value>You cannot see anything. </value>
        </item>
        <item>
          <key>darkeast</key>
          <value>You cannot see anything. You can feel a counter in front of you</value>
        </item>
        <item>
          <key>darksouth</key>
          <value>You cannot see anything. </value>
        </item>
        <item>
          <key>darkwest</key>
          <value>You cannot see anything. You can feel a counter in front of you.</value>
        </item>
        <item>
          <key>dimnorth</key>
          <value>There is a counter to the east, and to the west of you. You cannot see any blood on the ground.</value>
        </item>
        <item>
          <key>dimeast</key>
          <value>There is a counter in front of you. You cannot see any blood on the ground.</value>
        </item>
        <item>
          <key>dimsouth</key>
          <value>There is a counter to the east, and to the west of you. You cannot see any blood on the ground.</value>
        </item>
        <item>
          <key>dimwest</key>
          <value>There is a counter in front of you. You cannot see any blood on the ground.</value>
        </item>
        <item>
          <key>brightnorth</key>
          <value>There is a counter to the east, and to the west of you. You think you can see some blood on the ground a few steps ahead, but its hard to tell.</value>
        </item>
        <item>
          <key>brighteast</key>
          <value>There is a counter in front of you. You cannot see the trail of blood from here.</value>
        </item>
        <item>
          <key>brightsouth</key>
          <value>There is a counter to the east, and to the west of you. You cannot see the trail of blood from here.</value>
        </item>
        <item>
          <key>brightwest</key>
          <value>There is a counter in front of you. You cannot see the trail of blood from here.</value>
        </item>
      </descriptions>
      <bloodTrail type="boolean">false</bloodTrail>
      <description type="script">
        PrintRoomDesc (False)
      </description>
      <exit name="North85" alias="north" to="defaultroom">
        <inherit name="northdirection" />
        <runscript />
        <script type="script">
          MoveAndFace (kitchen49, 0)
        </script>
      </exit>
      <exit name="South85" alias="south" to="defaultroom">
        <inherit name="southdirection" />
        <runscript />
        <script type="script">
          MoveAndFace (kitchen51, 2)
        </script>
      </exit>
    </object>
    <object name="kitchen51">
      <inherit name="editor_room" />
      <usedefaultprefix />
      <descriptions type="stringdictionary">
        <item>
          <key>darknorth</key>
          <value>You cannot see anything. </value>
        </item>
        <item>
          <key>darkeast</key>
          <value>You cannot see anything. You can feel a counter in front of you.</value>
        </item>
        <item>
          <key>darksouth</key>
          <value>You cannot see anything. </value>
        </item>
        <item>
          <key>darkwest</key>
          <value>You cannot see anything. You can feel a counter in front of you.</value>
        </item>
        <item>
          <key>dimnorth</key>
          <value>There is a counter to the east, and to the west of you. You cannot see any blood on the ground.</value>
        </item>
        <item>
          <key>dimeast</key>
          <value>There is a counter in front of you. You cannot see any blood on the ground.</value>
        </item>
        <item>
          <key>dimsouth</key>
          <value>There is a counter to the east, and to the west of you. You cannot see any blood on the ground.</value>
        </item>
        <item>
          <key>dimwest</key>
          <value>There is a counter in front of you. You cannot see any blood on the ground.</value>
        </item>
        <item>
          <key>brightnorth</key>
          <value>There is a counter to the east, and to the west of you. You cannot see the trail of blood from here. </value>
        </item>
        <item>
          <key>brighteast</key>
          <value>There is a counter in front of you. You cannot see the trail of blood from here.</value>
        </item>
        <item>
          <key>brightsouth</key>
          <value>There is a counter to the east, and to the west of you. You cannot see the trail of blood from here. </value>
        </item>
        <item>
          <key>brightwest</key>
          <value>There is a counter in front of you. You cannot see the trail of blood from here.</value>
        </item>
      </descriptions>
      <bloodTrail type="boolean">false</bloodTrail>
      <description type="script">
        PrintRoomDesc (False)
      </description>
      <exit name="North86" alias="north" to="defaultroom">
        <inherit name="northdirection" />
        <runscript />
        <script type="script">
          MoveAndFace (kitchen50, 0)
        </script>
      </exit>
      <exit name="South86" alias="south" to="defaultroom">
        <inherit name="southdirection" />
        <runscript />
        <script type="script">
          MoveAndFace (kitchen52, 2)
        </script>
      </exit>
    </object>
    <object name="kitchen52">
      <inherit name="editor_room" />
      <usedefaultprefix />
      <descriptions type="stringdictionary">
        <item>
          <key>darknorth</key>
          <value>You cannot see anything. </value>
        </item>
        <item>
          <key>darkeast</key>
          <value>You cannot see anything. </value>
        </item>
        <item>
          <key>darksouth</key>
          <value>You cannot see anything. You can feel a counter in front of you.</value>
        </item>
        <item>
          <key>darkwest</key>
          <value>You cannot see anything. </value>
        </item>
        <item>
          <key>dimnorth</key>
          <value>You cannot see any blood on the ground.</value>
        </item>
        <item>
          <key>dimeast</key>
          <value>The ground in front of you looks a little weird. You cannot see any blood on the ground. </value>
        </item>
        <item>
          <key>dimsouth</key>
          <value>There is a counter in front of you. You cannot see any blood on the ground.</value>
        </item>
        <item>
          <key>dimwest</key>
          <value>You cannot see any blood on the ground.</value>
        </item>
        <item>
          <key>brightnorth</key>
          <value>You cannot see the trail of blood from here.</value>
        </item>
        <item>
          <key>brighteast</key>
          <value>The ground in front of you looks unstable. You cannot see the trail of blood from here.</value>
        </item>
        <item>
          <key>brightsouth</key>
          <value>There is a counter in front of you. The ground to the east of you looks unstable. You cannot see the trail of blood from here.</value>
        </item>
        <item>
          <key>brightwest</key>
          <value>You cannot see the trail of blood from here.</value>
        </item>
      </descriptions>
      <bloodTrail type="boolean">false</bloodTrail>
      <description type="script">
        PrintRoomDesc (False)
      </description>
      <exit name="North87" alias="north" to="defaultroom">
        <inherit name="northdirection" />
        <runscript />
        <script type="script">
          MoveAndFace (kitchen51, 0)
        </script>
      </exit>
      <exit name="East87" alias="east" to="defaultroom">
        <inherit name="eastdirection" />
        <runscript />
        <script type="script">
          MoveAndFace (kitchen45, 1)
        </script>
      </exit>
      <exit name="West87" alias="west" to="defaultroom">
        <inherit name="westdirection" />
        <runscript />
        <visible />
        <script type="script">
          MoveAndFace (kitchen54, 3)
        </script>
      </exit>
    </object>
    <object name="kitchen53">
      <inherit name="editor_room" />
      <usedefaultprefix />
      <descriptions type="stringdictionary">
        <item>
          <key>darknorth</key>
          <value>You cannot see anything. You can feel a wall in front of you.</value>
        </item>
        <item>
          <key>darkeast</key>
          <value>You cannot see anything. </value>
        </item>
        <item>
          <key>darksouth</key>
          <value>You cannot see anything. You can feel a counter in front of you.</value>
        </item>
        <item>
          <key>darkwest</key>
          <value>You cannot see anything. </value>
        </item>
        <item>
          <key>dimnorth</key>
          <value>There is a wall in front of you. There are some spots of blood on the ground.</value>
        </item>
        <item>
          <key>dimeast</key>
          <value>There is a wall to the north of you, and a counter to the south. There are some spots of blood on the ground.</value>
        </item>
        <item>
          <key>dimsouth</key>
          <value>There is a counter in front of you. You can see some spots of blood on the ground.</value>
        </item>
        <item>
          <key>dimwest</key>
          <value>There is a wall to the north of you, and a counter to the south. There are some spots of blood on the ground.</value>
        </item>
        <item>
          <key>brightnorth</key>
          <value>There is a wall in front of you. There is a trail of blood on the ground leading east, and breaks off to the west of you.</value>
        </item>
        <item>
          <key>brighteast</key>
          <value>There is a wall to the north of you, and a counter to the south. There is a trail of blood on the ground leading forwards.</value>
        </item>
        <item>
          <key>brightsouth</key>
          <value>There is a counter in front of you. There is a trail of blood on the ground leading east, and breaks off to the west of you.</value>
        </item>
        <item>
          <key>brightwest</key>
          <value>There is a wall to the north of you, and a counter to the south. There is a trail of blood on the ground that breaks off in front of you. </value>
        </item>
      </descriptions>
      <bloodTrail />
      <description type="script">
        PrintRoomDesc (False)
      </description>
      <exit name="East88" alias="east" to="defaultroom">
        <inherit name="eastdirection" />
        <runscript />
        <script type="script">
          MoveAndFace (kitchen46, 1)
        </script>
      </exit>
      <exit name="West88" alias="west" to="defaultroom">
        <inherit name="westdirection" />
        <runscript />
        <visible />
        <script type="script">
          MoveAndFace (kitchen55, 3)
        </script>
      </exit>
    </object>
    <object name="kitchen54">
      <inherit name="editor_room" />
      <usedefaultprefix />
      <descriptions type="stringdictionary">
        <item>
          <key>darknorth</key>
          <value>You cannot see anything. You can feel a counter in front of you.</value>
        </item>
        <item>
          <key>darkeast</key>
          <value>You cannot see anything. </value>
        </item>
        <item>
          <key>darksouth</key>
          <value>You cannot see anything. You can feel a counter in front of you.</value>
        </item>
        <item>
          <key>darkwest</key>
          <value>You cannot see anything. </value>
        </item>
        <item>
          <key>dimnorth</key>
          <value>There is a counter in front of you. You cannot see any blood on the ground.</value>
        </item>
        <item>
          <key>dimeast</key>
          <value>There is a counter to the north, and to the south of you. You cannot see any blood on the ground.</value>
        </item>
        <item>
          <key>dimsouth</key>
          <value>There is a counter in front of you. You cannot see any blood on the ground.</value>
        </item>
        <item>
          <key>dimwest</key>
          <value>There is a counter to the north and to the south of you. You cannot see any blood on the ground.</value>
        </item>
        <item>
          <key>brightnorth</key>
          <value>There is a counter in front of you. You cannot see the trail of blood from here.</value>
        </item>
        <item>
          <key>brighteast</key>
          <value>There is a counter to the north, and to the south of you. You cannot see the trail of blood from here.</value>
        </item>
        <item>
          <key>brightsouth</key>
          <value>There is a counter in front of you. You cannot see the trail of blood from here.</value>
        </item>
        <item>
          <key>brightwest</key>
          <value>There is a counter to the north, and to the south of you. You can see some blood on the ground a few steps ahead.</value>
        </item>
      </descriptions>
      <bloodTrail type="boolean">false</bloodTrail>
      <description type="script">
        PrintRoomDesc (False)
      </description>
      <exit name="East89" alias="east" to="defaultroom">
        <inherit name="eastdirection" />
        <runscript />
        <script type="script">
          MoveAndFace (kitchen52, 1)
        </script>
      </exit>
      <exit name="West89" alias="west" to="defaultroom">
        <inherit name="westdirection" />
        <runscript />
        <visible />
        <script type="script">
          MoveAndFace (kitchen61, 3)
        </script>
      </exit>
    </object>
    <object name="kitchen55">
      <inherit name="editor_room" />
      <usedefaultprefix />
      <descriptions type="stringdictionary">
        <item>
          <key>darknorth</key>
          <value>You cannot see anything. You can feel a wall in front of you.</value>
        </item>
        <item>
          <key>darkeast</key>
          <value>You cannot see anything. </value>
        </item>
        <item>
          <key>darksouth</key>
          <value>You cannot see anything. </value>
        </item>
        <item>
          <key>darkwest</key>
          <value>You cannot see anything. You can feel a counter in front of you.</value>
        </item>
        <item>
          <key>dimnorth</key>
          <value>There is a wall in front of you. You can hear some grunting coming from the west. You cannot see any blood on the ground.</value>
        </item>
        <item>
          <key>dimeast</key>
          <value>There is a wall to the north of you. You can hear some grunting coming from behind you. You cannot see any blood on the ground.</value>
        </item>
        <item>
          <key>dimsouth</key>
          <value>You can hear some grunting coming from the west. You cannot see any blood on the ground.</value>
        </item>
        <item>
          <key>dimwest</key>
          <value>There is a counter in front of you. You can hear some grunting coming from something on the other side of the counter. You cannot see any blood on the ground.</value>
        </item>
        <item>
          <key>brightnorth</key>
          <value>There is a wall in front of you. You can hear some grunting coming from the west, and your lantern light catches on some moving objects in your peripherals. You can see the trail of blood to the east of you.</value>
        </item>
        <item>
          <key>brighteast</key>
          <value>There is a wall to the north of you. You can hear some grunting coming from behind you. There is a trail of blood on the ground a step in front of you.</value>
        </item>
        <item>
          <key>brightsouth</key>
          <value>You can hear some grunting coming from the west, you can also see some of your lanterns light reflecting on some moving objects in your peripherals. There is a trail of blood on the ground a step in front of you.</value>
        </item>
        <item>
          <key>brightwest</key>
          <value>There is a counter in front of you. You can hear some grunting coming from something on the other side of the counter, and you can see some of your lanterns light reflect off of what looks like moving knives. There is some blood on the ground a step to the south of you.</value>
        </item>
      </descriptions>
      <bloodTrail type="boolean">false</bloodTrail>
      <description type="script">
        PrintRoomDesc (False)
      </description>
      <exit name="East90" alias="east" to="defaultroom">
        <inherit name="eastdirection" />
        <runscript />
        <script type="script">
          MoveAndFace (kitchen53, 1)
        </script>
      </exit>
      <exit name="South90" alias="south" to="defaultroom">
        <inherit name="southdirection" />
        <runscript />
        <script type="script">
          MoveAndFace (kitchen56, 2)
        </script>
      </exit>
    </object>
    <object name="kitchen56">
      <inherit name="editor_room" />
      <usedefaultprefix />
      <descriptions type="stringdictionary">
        <item>
          <key>darknorth</key>
          <value>You cannot see anything. </value>
        </item>
        <item>
          <key>darkeast</key>
          <value>You cannot see anything. You can feel a counter in front of you.</value>
        </item>
        <item>
          <key>darksouth</key>
          <value>You cannot see anything. </value>
        </item>
        <item>
          <key>darkwest</key>
          <value>You cannot see anything. You can feel a counter in front of you. </value>
        </item>
        <item>
          <key>dimnorth</key>
          <value>There is a counter to the east, and to the west of you. You can hear the piercing clang of metal on metal to the west. There are some spots of blood on the ground.</value>
        </item>
        <item>
          <key>dimeast</key>
          <value>There is a counter in front of you. You can hear the clang of metal on metal behind you. There are some spots of blood on the ground.</value>
        </item>
        <item>
          <key>dimsouth</key>
          <value>There is a counter to the east, and to the west of you. You can hear the clang of metal on metal to the west. There are some spots of blood on the ground.</value>
        </item>
        <item>
          <key>dimwest</key>
          <value>There is a counter in front of you. You can hear the clang of metal on metal on the other side of the counter. There are some spots of blood on the ground.</value>
        </item>
        <item>
          <key>brightnorth</key>
          <value>There is a counter to the east, and to the west of you. You can hear the piercing clang of metal on metal to the west. There is a trail of blood on the ground that breaks off in front of you.</value>
        </item>
        <item>
          <key>brighteast</key>
          <value>There is a counter in front of you. You can hear the clang of metal on metal behind you. There is a trail of blood on the ground leading south, and breaks off to the north.</value>
        </item>
        <item>
          <key>brightsouth</key>
          <value>There is a counter to the east, and to the west of you. You can hear the clang of metal on metal to the west. There is a trail of blood on the ground continue forwards. </value>
        </item>
        <item>
          <key>brightwest</key>
          <value>There is a counter in front of you. You can hear the clang of metal on metal on the other side of the counter. There is a trail of blood on the ground leading south, and breaks off to the north.</value>
        </item>
      </descriptions>
      <bloodTrail />
      <description type="script">
        PrintRoomDesc (False)
      </description>
      <exit name="North91" alias="north" to="defaultroom">
        <inherit name="northdirection" />
        <runscript />
        <script type="script">
          MoveAndFace (kitchen55, 0)
        </script>
      </exit>
      <exit name="South91" alias="south" to="defaultroom">
        <inherit name="southdirection" />
        <runscript />
        <script type="script">
          MoveAndFace (kitchen57, 2)
        </script>
      </exit>
    </object>
    <object name="kitchen57">
      <inherit name="editor_room" />
      <usedefaultprefix />
      <descriptions type="stringdictionary">
        <item>
          <key>darknorth</key>
          <value>You cannot see anything. </value>
        </item>
        <item>
          <key>darkeast</key>
          <value>You cannot see anything. You can feel a counter in front of you.</value>
        </item>
        <item>
          <key>darksouth</key>
          <value>You cannot see anything. </value>
        </item>
        <item>
          <key>darkwest</key>
          <value>You cannot see anything. You can feel a counter in front of you.</value>
        </item>
        <item>
          <key>dimnorth</key>
          <value>There is a counter to the east and to the west of you. You can see some spots of blood on the ground.</value>
        </item>
        <item>
          <key>dimeast</key>
          <value>There is a counter in front of you. There are some spots of blood on the ground.</value>
        </item>
        <item>
          <key>dimsouth</key>
          <value>There is a counter to the east, and to the west of you. There are some spots of blood on the ground.</value>
        </item>
        <item>
          <key>dimwest</key>
          <value>There is a counter in front of you. There are some spots of blood on the ground.</value>
        </item>
        <item>
          <key>brightnorth</key>
          <value>There is a counter to the east, and to the west of you. There is a trail of blood on the ground leading forwards.</value>
        </item>
        <item>
          <key>brighteast</key>
          <value>There is a counter in front of you. There is a trail of blood on the ground leading north and south of you. </value>
        </item>
        <item>
          <key>brightsouth</key>
          <value>There is a counter to the east, and to the west of you. There is a trail of blood leading forwards.</value>
        </item>
        <item>
          <key>brightwest</key>
          <value>There is a counter in front of you. There is a trail of blood on the ground leading to the north, and to the south of you.</value>
        </item>
      </descriptions>
      <bloodTrail />
      <description type="script">
        PrintRoomDesc (False)
      </description>
      <exit name="North92" alias="north" to="defaultroom">
        <inherit name="northdirection" />
        <runscript />
        <script type="script">
          MoveAndFace (kitchen56, 0)
        </script>
      </exit>
      <exit name="South92" alias="south" to="defaultroom">
        <inherit name="southdirection" />
        <runscript />
        <script type="script">
          MoveAndFace (kitchen58, 2)
        </script>
      </exit>
    </object>
    <object name="kitchen58">
      <inherit name="editor_room" />
      <usedefaultprefix />
      <descriptions type="stringdictionary">
        <item>
          <key>darknorth</key>
          <value>You cannot see anything. </value>
        </item>
        <item>
          <key>darkeast</key>
          <value>You cannot see anything. There is a counter in front of you.</value>
        </item>
        <item>
          <key>darksouth</key>
          <value>You cannot see anything. </value>
        </item>
        <item>
          <key>darkwest</key>
          <value>You cannot see anything. You can feel a counter in front of you. </value>
        </item>
        <item>
          <key>dimnorth</key>
          <value>There is a counter to the east, and to the west of you. There are some spots of blood on the ground.</value>
        </item>
        <item>
          <key>dimeast</key>
          <value>There is a counter in front of you. There are some spots of blood on the ground.</value>
        </item>
        <item>
          <key>dimsouth</key>
          <value>There is a counter to the east and to the west of you. There are some spots of blood on the ground.</value>
        </item>
        <item>
          <key>dimwest</key>
          <value>There is a counter in front of you. There are some spots of blood on the ground.</value>
        </item>
        <item>
          <key>brightnorth</key>
          <value>There is a counter to the east, and to the west of you. There is a trail of blood on the ground leading forwards. </value>
        </item>
        <item>
          <key>brighteast</key>
          <value>There is a counter in front of you. There is a trail of blood on the ground leading to the north, and breaks off to the south. </value>
        </item>
        <item>
          <key>brightsouth</key>
          <value>There is a counter to the east, and to the west of you. They look like they might fall, but you could probably fix them. There is a trail of blood on the ground that breaks off in front of you.</value>
        </item>
        <item>
          <key>brightwest</key>
          <value>There is a counter in front of you. There is a trail of blood on the ground leading north, and breaks off to the south.</value>
        </item>
      </descriptions>
      <bloodTrail />
      <description type="script">
        PrintRoomDesc (False)
      </description>
      <exit name="North93" alias="north" to="defaultroom">
        <inherit name="northdirection" />
        <runscript />
        <script type="script">
          MoveAndFace (kitchen57, 0)
        </script>
      </exit>
      <exit name="South93" alias="south" to="defaultroom">
        <inherit name="southdirection" />
        <runscript />
        <script type="script">
          MoveAndFace (kitchen59, 2)
        </script>
      </exit>
      <object name="knives">
        <inherit name="editor_object" />
        <alt type="stringlist">
          <value>plates</value>
        </alt>
        <gender>they</gender>
        <article>they</article>
        <displayverbs type="stringlist">
          <value>Look at</value>
        </displayverbs>
        <fixed type="boolean">false</fixed>
        <drop type="boolean">false</drop>
        <feature_usegive />
        <visible />
        <scenery />
        <fix type="script">
          msg ("You quietly push the knives to the center of the counter. They don't seem like they'll fall now.")
          knives.fixed = True
        </fix>
        <use type="script">
          msg ("You quietly push the knives to the center of the counter. They don't seem like they'll fall now.")
          knives.fixed = True
        </use>
        <move type="script">
          msg ("You quietly push the knives to the center of the counter. They don't seem like they'll fall now.")
          knives.fixed = True
        </move>
      </object>
      <turnscript name="knives_script">
        <enabled />
        <script><![CDATA[
          if (not knives.fixed) {
            if (Got(lantern)) {
              if (lantern.light_level = 1) {
                if (player.facing_num = 1) {
                  msg ("The counter in front of you has a bunch of knives laying on it. Some look like they might fall.")
                }
                else if (player.facing_num <> 3) {
                  msg ("The counter to the east has a bunch of knives laying on it. Some look like they might fall.")
                }
              }
              else if (lantern.light_level = 2) {
                if (player.facing_num = 1) {
                  msg ("The counter in front of you has a bunch of precariously placed knives on it. They look like they might fall, but you can probably fix them quietly.")
                }
                else if (player.facing_num <> 3) {
                  msg ("The counter to the east has a bunch of precariously placed knives on it. They look like they might fall, but you can probably fix them quietly.")
                }
              }
            }
          }
        ]]></script>
      </turnscript>
    </object>
    <object name="kitchen59">
      <inherit name="editor_room" />
      <usedefaultprefix />
      <descriptions type="stringdictionary">
        <item>
          <key>darknorth</key>
          <value>You cannot see anything. </value>
        </item>
        <item>
          <key>darkeast</key>
          <value>You cannot see anything. You can feel a counter in front of you.</value>
        </item>
        <item>
          <key>darksouth</key>
          <value>You cannot see anything. </value>
        </item>
        <item>
          <key>darkwest</key>
          <value>You cannot see anything. You can feel a counter in front of you. </value>
        </item>
        <item>
          <key>dimnorth</key>
          <value>There is a counter to the east, and to the west of you. You cannot see any blood on the ground.</value>
        </item>
        <item>
          <key>dimeast</key>
          <value>There is a counter in front of you. You cannot see any blood on the ground.</value>
        </item>
        <item>
          <key>dimsouth</key>
          <value>There is a counter to the east, and to the west of you. You cannot see any blood on the ground.</value>
        </item>
        <item>
          <key>dimwest</key>
          <value>There is a counter in front of you. You cannot see any blood on the ground.</value>
        </item>
        <item>
          <key>brightnorth</key>
          <value>There is a counter to the east, and to the west of you. There is some blood on the ground a step in front of you.</value>
        </item>
        <item>
          <key>brighteast</key>
          <value>There is a counter in front of you. There is some blood on the ground a step to the north, and to the south of you.</value>
        </item>
        <item>
          <key>brightsouth</key>
          <value>There is a counter to the east, and to the west of you. There is some blood on the ground a step forwards.</value>
        </item>
        <item>
          <key>brightwest</key>
          <value>There is a counter in front of you. There is some blood on the ground a step to the north, and to the south of you.</value>
        </item>
      </descriptions>
      <bloodTrail type="boolean">false</bloodTrail>
      <description type="script">
        if (knives.fixed) {
          PrintRoomDesc (False)
        }
        else {
          msg ("As you are moving, your lantern hits a knife that is sticking off the edge of the counter. You do not have enough time to react, and the knife falls, stabbing you in the foot. The lantern falls from your hand, crashing loudly to the ground, and exploding. You hear something grunt loudly in the distance, and then heavy stomps rush up to you. You are surrounded in darkness and feel a rush of air on your face before something swings down, and...")
          Die
        }
      </description>
      <exit name="North94" alias="north" to="defaultroom">
        <inherit name="northdirection" />
        <runscript />
        <script type="script">
          MoveAndFace (kitchen58, 0)
        </script>
      </exit>
      <exit name="South94" alias="south" to="defaultroom">
        <inherit name="southdirection" />
        <runscript />
        <script type="script">
          MoveAndFace (kitchen60, 2)
        </script>
      </exit>
    </object>
    <object name="kitchen60">
      <inherit name="editor_room" />
      <usedefaultprefix />
      <descriptions type="stringdictionary">
        <item>
          <key>darknorth</key>
          <value>You cannot see anything. </value>
        </item>
        <item>
          <key>darkeast</key>
          <value>You cannot see anything. You can feel a counter in front of you.</value>
        </item>
        <item>
          <key>darksouth</key>
          <value>You cannot see anything. </value>
        </item>
        <item>
          <key>darkwest</key>
          <value>You cannot see anything. You can feel a counter in front of you.</value>
        </item>
        <item>
          <key>dimnorth</key>
          <value>There is a counter to the east, and to the west of you. There are some spots of blood on the ground.</value>
        </item>
        <item>
          <key>dimeast</key>
          <value>There is a counter in front of you. There are some spots of blood on the ground.</value>
        </item>
        <item>
          <key>dimsouth</key>
          <value>There is a counter to the east, and to the west of you. There are some spots of blood on the ground.</value>
        </item>
        <item>
          <key>dimwest</key>
          <value>There is a counter in front of you. There are some spots of blood on the ground.</value>
        </item>
        <item>
          <key>brightnorth</key>
          <value>There is a counter to the east, and to the west of you. The trail of blood breaks off in front of you.</value>
        </item>
        <item>
          <key>brighteast</key>
          <value>There is a counter in front of you. The trail of blood breaks off to the north, and to the south of you.</value>
        </item>
        <item>
          <key>brightsouth</key>
          <value>There is a counter to the east, and to the west of you. The trail of blood breaks off in front of you.</value>
        </item>
        <item>
          <key>brightwest</key>
          <value>There is a counter in front of you. The trail of blood breaks off to the north, and to the south of you.</value>
        </item>
      </descriptions>
      <bloodTrail />
      <description type="script">
        PrintRoomDesc (False)
      </description>
      <exit name="North95" alias="north" to="defaultroom">
        <inherit name="northdirection" />
        <runscript />
        <script type="script">
          MoveAndFace (kitchen59, 0)
        </script>
      </exit>
      <exit name="South95" alias="south" to="defaultroom">
        <inherit name="southdirection" />
        <runscript />
        <script type="script">
          MoveAndFace (kitchen61, 2)
        </script>
      </exit>
    </object>
    <object name="kitchen61">
      <inherit name="editor_room" />
      <usedefaultprefix />
      <descriptions type="stringdictionary">
        <item>
          <key>darknorth</key>
          <value>You cannot see anything. </value>
        </item>
        <item>
          <key>darkeast</key>
          <value>You cannot see anything. </value>
        </item>
        <item>
          <key>darksouth</key>
          <value>You cannot see anything. You can feel a counter in front of you. </value>
        </item>
        <item>
          <key>darkwest</key>
          <value>You cannot see anything. </value>
        </item>
        <item>
          <key>dimnorth</key>
          <value>You cannot see any blood on the ground.</value>
        </item>
        <item>
          <key>dimeast</key>
          <value>There is a counter to the south of you. You cannot see any blood on the ground.</value>
        </item>
        <item>
          <key>dimsouth</key>
          <value>There is a counter in front of you. You cannot see any blood on the ground.</value>
        </item>
        <item>
          <key>dimwest</key>
          <value>There is a counter to the south of you. You cannot see any blood on the ground.</value>
        </item>
        <item>
          <key>brightnorth</key>
          <value>There is a trail of blood a step forwards, and a step to the west.</value>
        </item>
        <item>
          <key>brighteast</key>
          <value>There is a counter to the south of you. There is some blood on the ground a step north of you.</value>
        </item>
        <item>
          <key>brightsouth</key>
          <value>There is a counter in front of you. There is some blood on the ground a step to the west of you.</value>
        </item>
        <item>
          <key>brightwest</key>
          <value>There is a counter to the south of you. There is some blood on the ground a step forwards.</value>
        </item>
      </descriptions>
      <bloodTrail type="boolean">false</bloodTrail>
      <description type="script">
        PrintRoomDesc (False)
      </description>
      <exit name="North96" alias="north" to="defaultroom">
        <inherit name="northdirection" />
        <runscript />
        <script type="script">
          MoveAndFace (kitchen60, 0)
        </script>
      </exit>
      <exit name="East96" alias="east" to="defaultroom">
        <inherit name="eastdirection" />
        <runscript />
        <script type="script">
          MoveAndFace (kitchen54, 1)
        </script>
      </exit>
      <exit name="West96" alias="west" to="defaultroom">
        <inherit name="westdirection" />
        <runscript />
        <visible />
        <script type="script">
          MoveAndFace (kitchen65, 3)
        </script>
      </exit>
    </object>
    <object name="kitchen62">
      <inherit name="editor_room" />
      <usedefaultprefix />
      <descriptions type="stringdictionary">
        <item>
          <key>darknorth</key>
          <value>You cannot see anything. You can feel a counter in front of you.</value>
        </item>
        <item>
          <key>darkeast</key>
          <value>You cannot see anything. You can feel a counter in front of you.</value>
        </item>
        <item>
          <key>darksouth</key>
          <value>You cannot see anything. </value>
        </item>
        <item>
          <key>darkwest</key>
          <value>You cannot see anything. </value>
        </item>
        <item>
          <key>dimnorth</key>
          <value>There is a counter in front of you, and to the east of you. There are some spots of blood on the ground.</value>
        </item>
        <item>
          <key>dimeast</key>
          <value>There is a counter in front of you, and to the north of you. There are some spots of blood on the ground.</value>
        </item>
        <item>
          <key>dimsouth</key>
          <value>There is a counter to the east of you. There are some spots of blood on the ground.</value>
        </item>
        <item>
          <key>dimwest</key>
          <value>There is a counter to the north of you. There are some spots of blood on the ground.</value>
        </item>
        <item>
          <key>brightnorth</key>
          <value>There is a counter in front of you, and to the east of you. There is a trail of blood on the ground that breaks off to the west. </value>
        </item>
        <item>
          <key>brighteast</key>
          <value>There is a counter in front of you, and to the north you. There are some pots and pans on the counter a step south of you. There is a trail of blood on the ground leading south.</value>
        </item>
        <item>
          <key>brightsouth</key>
          <value>There is a counter to the east of you. A step ahead there are some dirty pots and pans on the counter. There is a trail of blood on the ground leading forwards.</value>
        </item>
        <item>
          <key>brightwest</key>
          <value>There is a counter to the north of you. There is a trail of blood on the ground leading south, and breaks off in front of you.</value>
        </item>
      </descriptions>
      <bloodTrail />
      <description type="script">
        PrintRoomDesc (False)
      </description>
      <exit name="South97" alias="south" to="defaultroom">
        <inherit name="southdirection" />
        <runscript />
        <script type="script">
          MoveAndFace (kitchen63, 2)
        </script>
      </exit>
      <exit name="West97" alias="west" to="defaultroom">
        <inherit name="westdirection" />
        <runscript />
        <visible />
        <script type="script">
          MoveAndFace (kitchen66, 3)
        </script>
      </exit>
    </object>
    <object name="kitchen63">
      <inherit name="editor_room" />
      <usedefaultprefix />
      <descriptions type="stringdictionary">
        <item>
          <key>darknorth</key>
          <value>You cannot see anything. </value>
        </item>
        <item>
          <key>darkeast</key>
          <value>You cannot see anything. You can feel a counter in front of you.</value>
        </item>
        <item>
          <key>darksouth</key>
          <value>You cannot see anything. You can feel a counter in front of you.</value>
        </item>
        <item>
          <key>darkwest</key>
          <value>You cannot see anything. You can feel a counter in front of you.</value>
        </item>
        <item>
          <key>dimnorth</key>
          <value>There is a counter to the east, and to the west of you. The counter to the east has a bunch of dirty pots and pans on it. The counter to the west has a rotting turkey carcass laying on a platter. There are some spots of blood on the ground.</value>
        </item>
        <item>
          <key>dimeast</key>
          <value>There is a counter in front of you. There are a bunch of dirty pots and pans on it. There are some spots of blood on the ground.</value>
        </item>
        <item>
          <key>dimsouth</key>
          <value>There is a counter to the east, and to the west of you. The counter to the east has a bunch of pots and pans on it, and the counter to the west has a rotting turkey carcass laying on it. There are some spots of blood on the ground. </value>
        </item>
        <item>
          <key>dimwest</key>
          <value>There is a counter in front of you. There is a rotting turkey carcass, laying on a platter, on it. There are some spots of blood on the ground, and smeared onto the counter.</value>
        </item>
        <item>
          <key>brightnorth</key>
          <value>There is a counter to the east, and to the west of you. The counter to the east has a bunch of dirty pots and pans on it. The counter to the west has a rotting turkey carcass laying on a platter. There is a trail of blood on the ground that leads forwards.</value>
        </item>
        <item>
          <key>brighteast</key>
          <value>There is a counter in front of you. There are a bunch of dirty pots and pans on it. There is a trail of blood on the ground that leads north, and breaks off to the south. </value>
        </item>
        <item>
          <key>brightsouth</key>
          <value>There is a counter to the east, and to the west of you. The counter to the east has a bunch of pots and pans on it, and the counter to the west has a rotting turkey carcass laying on it. There is a trail of blood on the ground that breaks off in front of you.</value>
        </item>
        <item>
          <key>brightwest</key>
          <value>There is a counter in front of you. There is a rotting turkey carcass, laying on a platter, on it. There is a trail of blood that smears onto the side of the counter in front of you.</value>
        </item>
      </descriptions>
      <bloodTrail />
      <description type="script">
        PrintRoomDesc (False)
      </description>
      <exit name="North98" alias="north" to="defaultroom">
        <inherit name="northdirection" />
        <runscript />
        <script type="script">
          MoveAndFace (kitchen62, 0)
        </script>
      </exit>
      <exit name="South98" alias="south" to="defaultroom">
        <inherit name="southdirection" />
        <runscript />
        <script type="script">
          MoveAndFace (kitchen64, 2)
        </script>
      </exit>
      <object name="pots1">
        <inherit name="editor_object" />
        <alias>pots</alias>
        <alt type="stringlist">
          <value>pots and pans</value>
          <value>pans</value>
        </alt>
        <feature_usegive />
        <push>EndKitchen</push>
        <use type="script">
          EndKitchen
        </use>
        <rattle type="script">
          EndKitchen
        </rattle>
        <hit type="script">
          EndKitchen
        </hit>
        <smack type="script">
          EndKitchen
        </smack>
        <knockdown type="script">
          EndKitchen
        </knockdown>
        <knockover type="script">
          EndKitchen
        </knockover>
      </object>
    </object>
    <object name="kitchen64">
      <inherit name="editor_room" />
      <usedefaultprefix />
      <descriptions type="stringdictionary">
        <item>
          <key>darknorth</key>
          <value>You cannot see anything. </value>
        </item>
        <item>
          <key>darkeast</key>
          <value>You cannot see anything. You can feel a counter in front of you.</value>
        </item>
        <item>
          <key>darksouth</key>
          <value>You cannot see anything. You can feel a wall in front of you.</value>
        </item>
        <item>
          <key>darkwest</key>
          <value>You cannot see anything. </value>
        </item>
        <item>
          <key>dimnorth</key>
          <value>There is a counter to the east of you. You cannot see any blood on the ground.</value>
        </item>
        <item>
          <key>dimeast</key>
          <value>There is a counter in front of you. You cannot see any blood on the ground.</value>
        </item>
        <item>
          <key>dimsouth</key>
          <value>There is a wall in front of you, and a counter to the east of you. You cannot see any blood on the ground.</value>
        </item>
        <item>
          <key>dimwest</key>
          <value>You cannot see any blood on the ground.</value>
        </item>
        <item>
          <key>brightnorth</key>
          <value>There is a counter to the east of you. You can see some blood on the ground a step ahead, and a step west of you.</value>
        </item>
        <item>
          <key>brighteast</key>
          <value>There is a counter in front of you. You can see some blood on the ground to the north of you.</value>
        </item>
        <item>
          <key>brightsouth</key>
          <value>There is a wall in front of you, and a counter to the east of you. There is some blood on the ground a step west of you.</value>
        </item>
        <item>
          <key>brightwest</key>
          <value>There is some blood on the ground a step in front of you. </value>
        </item>
      </descriptions>
      <bloodTrail type="boolean">false</bloodTrail>
      <description type="script">
        PrintRoomDesc (False)
      </description>
      <exit name="North99" alias="north" to="defaultroom">
        <inherit name="northdirection" />
        <runscript />
        <script type="script">
          MoveAndFace (kitchen63, 0)
        </script>
      </exit>
      <exit name="West99" alias="west" to="defaultroom">
        <inherit name="westdirection" />
        <runscript />
        <visible />
        <script type="script">
          MoveAndFace (kitchen67, 3)
        </script>
      </exit>
    </object>
    <object name="kitchen65">
      <inherit name="editor_room" />
      <usedefaultprefix />
      <descriptions type="stringdictionary">
        <item>
          <key>darknorth</key>
          <value>You cannot see anything. You can feel a counter in front of you.</value>
        </item>
        <item>
          <key>darkeast</key>
          <value>You cannot see anything. </value>
        </item>
        <item>
          <key>darksouth</key>
          <value>You cannot see anything. You can feel a counter in front of you.</value>
        </item>
        <item>
          <key>darkwest</key>
          <value>You cannot see anything. </value>
        </item>
        <item>
          <key>dimnorth</key>
          <value>There is a counter in front of you. There are some spots of blood on the ground.</value>
        </item>
        <item>
          <key>dimeast</key>
          <value>There is a counter to the north, and to the south of you. There are some spots of blood on the ground.</value>
        </item>
        <item>
          <key>dimsouth</key>
          <value>There is a counter in front of you. There are some spots of blood on the ground.</value>
        </item>
        <item>
          <key>dimwest</key>
          <value>There is a counter to the north, and to the south of you. There are some spots of blood on the ground.</value>
        </item>
        <item>
          <key>brightnorth</key>
          <value>There is a counter in front of you. There is a trail of blood on the ground leading west.</value>
        </item>
        <item>
          <key>brighteast</key>
          <value>There is a counter to the north, and to the south of you. There is a trail of blood on the ground that breaks off in front of you.</value>
        </item>
        <item>
          <key>brightsouth</key>
          <value>There is a counter in front of you. There is a trail of blood on the ground leading west.</value>
        </item>
        <item>
          <key>brightwest</key>
          <value>There is a counter to the north, and to the south of you. There is a trail of blood on the ground leading forwards.</value>
        </item>
      </descriptions>
      <bloodTrail />
      <description type="script">
        PrintRoomDesc (False)
      </description>
      <exit name="East100" alias="east" to="defaultroom">
        <inherit name="eastdirection" />
        <runscript />
        <script type="script">
          MoveAndFace (kitchen61, 1)
        </script>
      </exit>
      <exit name="West100" alias="west" to="defaultroom">
        <inherit name="westdirection" />
        <runscript />
        <visible />
        <script type="script">
          MoveAndFace (kitchen68, 3)
        </script>
      </exit>
    </object>
    <object name="kitchen66">
      <inherit name="editor_room" />
      <usedefaultprefix />
      <descriptions type="stringdictionary">
        <item>
          <key>darknorth</key>
          <value>You cannot see anything. You can feel a counter in front of you.</value>
        </item>
        <item>
          <key>darkeast</key>
          <value>You cannot see anything.</value>
        </item>
        <item>
          <key>darksouth</key>
          <value>You cannot see anything. You can feel a counter in front of you.</value>
        </item>
        <item>
          <key>darkwest</key>
          <value>You cannot see anything. </value>
        </item>
        <item>
          <key>dimnorth</key>
          <value>There is a counter in front of you. You cannot see any blood on the ground.</value>
        </item>
        <item>
          <key>dimeast</key>
          <value>There is a counter to north, and to the south of you. The counter to the south of you has a rotting turkey carcass laying on it. You cannot see any blood on the ground.</value>
        </item>
        <item>
          <key>dimsouth</key>
          <value>There is a counter in front of you, it has a rotting turkey carcass laying on it. You cannot see any blood on the ground.</value>
        </item>
        <item>
          <key>dimwest</key>
          <value>There is a counter to the north, and to the south of you. The counter to the south of you has a rotting turkey carcass laying on it. You cannot see any blood on the ground.</value>
        </item>
        <item>
          <key>brightnorth</key>
          <value>There is a counter in front of you. There is a trail of blood on the ground to the east of you.</value>
        </item>
        <item>
          <key>brighteast</key>
          <value>There is a counter to the north, and to the south of you. The counter to the south of you has a rotting turkey carcass laying on it. There are some spots of blood on the ground a step forwards.</value>
        </item>
        <item>
          <key>brightsouth</key>
          <value>There is a counter in front of you, it has a rotting turkey carcass laying on it. There are some spots of blood on the ground a step to the east of you.</value>
        </item>
        <item>
          <key>brightwest</key>
          <value>There is a counter to the north, and to the south of you. The counter to the south of you has a rotting turkey carcass laying on it. You cannot see the trail of blood from here.</value>
        </item>
      </descriptions>
      <bloodTrail type="boolean">false</bloodTrail>
      <description type="script">
        PrintRoomDesc (False)
      </description>
      <exit name="East101" alias="east" to="defaultroom">
        <inherit name="eastdirection" />
        <runscript />
        <script type="script">
          MoveAndFace (kitchen62, 1)
        </script>
      </exit>
      <exit name="West101" alias="west" to="defaultroom">
        <inherit name="westdirection" />
        <runscript />
        <visible />
        <script type="script">
          MoveAndFace (kitchen69, 3)
        </script>
      </exit>
    </object>
    <object name="kitchen67">
      <inherit name="editor_room" />
      <usedefaultprefix />
      <descriptions type="stringdictionary">
        <item>
          <key>darknorth</key>
          <value>You cannot see anything. You can feel a counter in front of you.</value>
        </item>
        <item>
          <key>darkeast</key>
          <value>You cannot see anything. </value>
        </item>
        <item>
          <key>darksouth</key>
          <value>You cannot see anything. You can feel a wall in front of you.</value>
        </item>
        <item>
          <key>darkwest</key>
          <value>You cannot see anything. </value>
        </item>
        <item>
          <key>dimnorth</key>
          <value>There is a counter in front of you. There is a rotting turkey carcass laying on it. There are some spots of blood on the ground.</value>
        </item>
        <item>
          <key>dimeast</key>
          <value>There is a counter to the north of you, and a wall to the south. The counter has a rotting turkey carcass laying on it. There are some spots of blood on the ground.</value>
        </item>
        <item>
          <key>dimsouth</key>
          <value>There is a wall in front of you. There are some spots of blood on the ground.</value>
        </item>
        <item>
          <key>dimwest</key>
          <value>There is a counter to the north of you, and a wall to the south. There is a rotting turkey carcass on the counter to the north. There are some spots of blood on the ground.</value>
        </item>
        <item>
          <key>brightnorth</key>
          <value>There is a counter in front of you. There is a rotting turkey carcass laying on it. The trail of blood on the ground breaks off to the east, and to the west of you.</value>
        </item>
        <item>
          <key>brighteast</key>
          <value>There is a counter to the north of you, and a wall to the south. The counter has a rotting turkey carcass laying on it. There is a trail of blood on the ground that breaks off in front of you.</value>
        </item>
        <item>
          <key>brightsouth</key>
          <value>There is a wall in front of you. The trail of blood on the ground breaks off to the east, and west of you. </value>
        </item>
        <item>
          <key>brightwest</key>
          <value>There is a counter to the north of you, and a wall to the south. There is a rotting turkey carcass on the counter to the north. There is a trail of blood that breaks off in front of you.</value>
        </item>
      </descriptions>
      <bloodTrail />
      <description type="script">
        PrintRoomDesc (False)
      </description>
      <exit name="East102" alias="east" to="defaultroom">
        <inherit name="eastdirection" />
        <runscript />
        <script type="script">
          MoveAndFace (kitchen64, 1)
        </script>
      </exit>
      <exit name="West102" alias="west" to="defaultroom">
        <inherit name="westdirection" />
        <runscript />
        <visible />
        <script type="script">
          MoveAndFace (kitchen71, 3)
        </script>
      </exit>
    </object>
    <object name="kitchen68">
      <inherit name="editor_room" />
      <usedefaultprefix />
      <descriptions type="stringdictionary">
        <item>
          <key>darknorth</key>
          <value>You cannot see anything. You can feel a counter in front of you.</value>
        </item>
        <item>
          <key>darkeast</key>
          <value>You cannot see anything. </value>
        </item>
        <item>
          <key>darksouth</key>
          <value>You cannot see anything. You can feel a counter in front of you.</value>
        </item>
        <item>
          <key>darkwest</key>
          <value>You cannot see anything. </value>
        </item>
        <item>
          <key>dimnorth</key>
          <value>There is a counter in front of you. There are some spots of blood on the ground.</value>
        </item>
        <item>
          <key>dimeast</key>
          <value>There is a counter to the north, and to the south of you. There are some spots of blood on the ground.</value>
        </item>
        <item>
          <key>dimsouth</key>
          <value>There is a counter in front of you. There are some spots of blood on the ground.</value>
        </item>
        <item>
          <key>dimwest</key>
          <value>There is a counter to the north, and to the south of you. There are some spots of blood on the ground.</value>
        </item>
        <item>
          <key>brightnorth</key>
          <value>There is a counter in front of you. There is a trail of blood on the ground that continues east of you, and breaks off to the west.</value>
        </item>
        <item>
          <key>brighteast</key>
          <value>There is a counter to the north, and to the south of you. There is a trail of blood on the ground that leads forwards.</value>
        </item>
        <item>
          <key>brightsouth</key>
          <value>There is a counter in front of you. There is a trail of blood on the ground that continues east of you, and breaks off to the west.</value>
        </item>
        <item>
          <key>brightwest</key>
          <value>There is a counter to the north, and to the south of you. There is a trail of blood on the ground that breaks off in front of you. </value>
        </item>
      </descriptions>
      <bloodTrail />
      <description type="script"><![CDATA[
        PrintRoomDesc (False)
        if (not oil2.parent = null and lantern.light_level > 0) {
          if (player.facing_num = 2) {
            msg ("The counter in front of you has a cask of oil sitting on it.")
          }
          else if (player.facing_num <> 0) {
            msg ("The counter to the south has a cask of oil sitting on it.")
          }
        }
      ]]></description>
      <exit name="East103" alias="east" to="defaultroom">
        <inherit name="eastdirection" />
        <runscript />
        <script type="script">
          MoveAndFace (kitchen65, 1)
        </script>
      </exit>
      <exit name="West103" alias="west" to="defaultroom">
        <inherit name="westdirection" />
        <runscript />
        <visible />
        <script type="script">
          MoveAndFace (kitchen74, 3)
        </script>
      </exit>
      <object name="oil2">
        <inherit name="editor_object" />
        <alt type="stringlist">
          <value>cask</value>
        </alt>
        <alias>oil</alias>
        <scenery />
        <feature_usegive />
        <take type="script">
          GetOil (oil2)
        </take>
        <use type="script">
          GetOil (oil2)
        </use>
      </object>
    </object>
    <object name="kitchen69">
      <inherit name="editor_room" />
      <usedefaultprefix />
      <descriptions type="stringdictionary">
        <item>
          <key>darknorth</key>
          <value>You cannot see anything. You can feel a counter in front of you.</value>
        </item>
        <item>
          <key>darkeast</key>
          <value>You cannot see anything. </value>
        </item>
        <item>
          <key>darksouth</key>
          <value>You cannot see anything. </value>
        </item>
        <item>
          <key>darkwest</key>
          <value>You cannot see anything. </value>
        </item>
        <item>
          <key>dimnorth</key>
          <value>There is a counter in front of you. You cannot see any blood on the ground.</value>
        </item>
        <item>
          <key>dimeast</key>
          <value>There is a counter to the north of you. You cannot see any blood on the ground.</value>
        </item>
        <item>
          <key>dimsouth</key>
          <value>You cannot see any blood on the ground.</value>
        </item>
        <item>
          <key>dimwest</key>
          <value>There is a counter to the north of you. You cannot see any blood on the ground.</value>
        </item>
        <item>
          <key>brightnorth</key>
          <value>There is a counter in front of you. You cannot see the trail of blood from here. </value>
        </item>
        <item>
          <key>brighteast</key>
          <value>There is a counter to the north of you. There is some blood on the ground a step to the south of you.</value>
        </item>
        <item>
          <key>brightsouth</key>
          <value>There is some blood on the ground a step forwards.</value>
        </item>
        <item>
          <key>brightwest</key>
          <value>There is a counter to the north of you. There is some blood on the ground a step south of you.</value>
        </item>
      </descriptions>
      <bloodTrail type="boolean">false</bloodTrail>
      <description type="script"><![CDATA[
        PrintRoomDesc (False)
        if (not oil2.parent = null and lantern.light_level > 0) {
          if (player.facing_num = 0) {
            msg ("The counter in front of you has a cask of oil sitting on it.")
          }
          else if (player.facing_num <> 2) {
            msg ("The counter to the north has a cask of oil sitting on it.")
          }
        }
      ]]></description>
      <exit name="East104" alias="east" to="defaultroom">
        <inherit name="eastdirection" />
        <runscript />
        <script type="script">
          MoveAndFace (kitchen66, 1)
        </script>
      </exit>
      <exit name="South104" alias="south" to="defaultroom">
        <inherit name="southdirection" />
        <runscript />
        <script type="script">
          MoveAndFace (kitchen70, 2)
        </script>
      </exit>
      <exit name="West104" alias="west" to="defaultroom">
        <inherit name="westdirection" />
        <runscript />
        <visible />
        <script type="script">
          MoveAndFace (kitchen76, 3)
        </script>
      </exit>
    </object>
    <object name="kitchen70">
      <inherit name="editor_room" />
      <usedefaultprefix />
      <descriptions type="stringdictionary">
        <item>
          <key>darknorth</key>
          <value>You cannot see anything. </value>
        </item>
        <item>
          <key>darkeast</key>
          <value>You cannot see anything. You can feel a counter in front of you.</value>
        </item>
        <item>
          <key>darksouth</key>
          <value>You cannot see anything. </value>
        </item>
        <item>
          <key>darkwest</key>
          <value>You cannot see anything. </value>
        </item>
        <item>
          <key>dimnorth</key>
          <value>There is a counter to the east of you, it has a rotting turkey carcass on it. There are some spots of blood on the ground.</value>
        </item>
        <item>
          <key>dimeast</key>
          <value>There is a counter in front of you, it has a rotting turkey carcass on it. There are some spots of blood on the ground.</value>
        </item>
        <item>
          <key>dimsouth</key>
          <value>There is a counter to the east of you, it has a rotting turkey carcass on it. There are some spots of blood on the ground.</value>
        </item>
        <item>
          <key>dimwest</key>
          <value>There are some spots of blood on the ground.</value>
        </item>
        <item>
          <key>brightnorth</key>
          <value>There is a counter to the east of you, it has a rotting turkey carcass on it. The trail of blood breaks off in front of you.</value>
        </item>
        <item>
          <key>brighteast</key>
          <value>There is a counter in front of you, it has a rotting turkey carcass on it. The trail of blood breaks off to the north, and south of you.</value>
        </item>
        <item>
          <key>brightsouth</key>
          <value>There is a counter to the east of you, it has a rotting turkey carcass on it. The trail of blood breaks off in front of you, but you think you can see some a few steps southeast of you.</value>
        </item>
        <item>
          <key>brightwest</key>
          <value>There is a trail of blood on the ground leading forwards.</value>
        </item>
      </descriptions>
      <bloodTrail />
      <description type="script">
        PrintRoomDesc (False)
      </description>
      <exit name="North105" alias="north" to="defaultroom">
        <inherit name="northdirection" />
        <runscript />
        <script type="script">
          MoveAndFace (kitchen69, 0)
        </script>
      </exit>
      <exit name="South105" alias="south" to="defaultroom">
        <inherit name="southdirection" />
        <runscript />
        <script type="script">
          MoveAndFace (kitchen71, 2)
        </script>
      </exit>
      <exit name="West105" alias="west" to="defaultroom">
        <inherit name="westdirection" />
        <runscript />
        <visible />
        <script type="script">
          MoveAndFace (kitchen77, 3)
        </script>
      </exit>
      <object name="turkey">
        <inherit name="editor_object" />
        <alt type="stringlist">
          <value>turkey carcass</value>
        </alt>
        <look type="script">
        </look>
      </object>
    </object>
    <object name="kitchen71">
      <inherit name="editor_room" />
      <usedefaultprefix />
      <descriptions type="stringdictionary">
        <item>
          <key>darknorth</key>
          <value>You cannot see anything. </value>
        </item>
        <item>
          <key>darkeast</key>
          <value>You cannot see anything. </value>
        </item>
        <item>
          <key>darksouth</key>
          <value>You cannot see anything. You can feel a wall in front of you.</value>
        </item>
        <item>
          <key>darkwest</key>
          <value>You cannot see anything. You can feel a counter in front of you.</value>
        </item>
        <item>
          <key>dimnorth</key>
          <value>There is a counter to the west of you. You cannot see any blood on the ground.</value>
        </item>
        <item>
          <key>dimeast</key>
          <value>There is a wall to the south of you. You cannot see any blood on the ground.</value>
        </item>
        <item>
          <key>dimsouth</key>
          <value>There is a wall in front of you, and a counter to the west of you. You cannot see any blood on the ground.</value>
        </item>
        <item>
          <key>dimwest</key>
          <value>There is a counter in front of you, and a wall to the south of you. You cannot see any blood on the ground.</value>
        </item>
        <item>
          <key>brightnorth</key>
          <value>There is a counter to the west of you. There are some spots of blood on the ground a step forwards, and to the east of you.</value>
        </item>
        <item>
          <key>brighteast</key>
          <value>There is a wall to the south of you. There is some blood on the ground a step east of you, and a step north of you.</value>
        </item>
        <item>
          <key>brightsouth</key>
          <value>There is a wall in front of you, and a counter to the west of you. There is some blood on the ground a step to the east of you.</value>
        </item>
        <item>
          <key>brightwest</key>
          <value>There is a counter in front of you, and a wall to the south of you. There is some blood on the ground a step to the north of you. </value>
        </item>
      </descriptions>
      <bloodTrail type="boolean">false</bloodTrail>
      <description type="script">
        PrintRoomDesc (False)
      </description>
      <exit name="North106" alias="north" to="defaultroom">
        <inherit name="northdirection" />
        <runscript />
        <script type="script">
          MoveAndFace (kitchen70, 0)
        </script>
      </exit>
      <exit name="East106" alias="east" to="defaultroom">
        <inherit name="eastdirection" />
        <runscript />
        <script type="script">
          MoveAndFace (kitchen67, 1)
        </script>
      </exit>
    </object>
    <object name="kitchen72">
      <inherit name="editor_room" />
      <usedefaultprefix />
      <descriptions type="stringdictionary">
        <item>
          <key>darknorth</key>
          <value>TODO: implement this description</value>
        </item>
        <item>
          <key>darkeast</key>
          <value>TODO: implement this description</value>
        </item>
        <item>
          <key>darksouth</key>
          <value>TODO: implement this description</value>
        </item>
        <item>
          <key>darkwest</key>
          <value>TODO: implement this description</value>
        </item>
        <item>
          <key>dimnorth</key>
          <value>TODO: implement this description</value>
        </item>
        <item>
          <key>dimeast</key>
          <value>TODO: implement this description</value>
        </item>
        <item>
          <key>dimsouth</key>
          <value>TODO: implement this description</value>
        </item>
        <item>
          <key>dimwest</key>
          <value>TODO: implement this description</value>
        </item>
        <item>
          <key>brightnorth</key>
          <value>TODO: implement this description</value>
        </item>
        <item>
          <key>brighteast</key>
          <value>TODO: implement this description</value>
        </item>
        <item>
          <key>brightsouth</key>
          <value>TODO: implement this description</value>
        </item>
        <item>
          <key>brightwest</key>
          <value>TODO: implement this description</value>
        </item>
      </descriptions>
      <bloodTrail type="boolean">false</bloodTrail>
      <description type="script">
        msg ("As you walk forward, you become aware of a dark presence in front of you. You inch forward into the darkness -- perhaps out of morbid curiosity, or perhaps out of foolhardy bravery.")
        msg ("The monster comes into sight. It is a huge, and wide creature, made of shadows and dripping blood. All you can see in the mass of shadows is a fanged mouth, filled with sharp talons for teeth. It is wielding a large butchers knife, covered in the blood and guts of the meat surrounding him.")
        msg ("It charges.")
        msg ("You close your eyes.")
        Die
      </description>
      <beforeenter type="script">
      </beforeenter>
    </object>
    <object name="kitchen73">
      <inherit name="editor_room" />
      <usedefaultprefix />
      <descriptions type="stringdictionary">
        <item>
          <key>darknorth</key>
          <value>You cannot see anything. </value>
        </item>
        <item>
          <key>darkeast</key>
          <value>You cannot see anything. You can feel a counter in front of you.</value>
        </item>
        <item>
          <key>darksouth</key>
          <value>You cannot see anything. </value>
        </item>
        <item>
          <key>darkwest</key>
          <value>You cannot see anything. You can feel a counter in front of you.</value>
        </item>
        <item>
          <key>dimnorth</key>
          <value>There is a counter to the east, and to the west of you. Up ahead you see something moving in the shadows, it looks like a large knife is catching your lanterns light as it moves. You cannot see any blood on the ground. </value>
        </item>
        <item>
          <key>dimeast</key>
          <value>There is counter in front of you. You can hear grunting nearby. You cannot see any blood on the ground.</value>
        </item>
        <item>
          <key>dimsouth</key>
          <value>There is a counter to the east, and to the west of you. You can hear grunting nearby. You cannot see any blood on the ground.</value>
        </item>
        <item>
          <key>dimwest</key>
          <value>There is a counter in front of you. You can hear grunting nearby. You cannot see any blood on the ground.</value>
        </item>
        <item>
          <key>brightnorth</key>
          <value>There is a counter to the east, and to the west of you. You cannot see the trail of blood from here, but up ahead you see something moving. It looks like it is swinging a butchers knife. </value>
        </item>
        <item>
          <key>brighteast</key>
          <value>There is a counter in front of you. You can hear grunting nearby. You cannot see the trail of blood from here.</value>
        </item>
        <item>
          <key>brightsouth</key>
          <value>TODO: implement this description</value>
        </item>
        <item>
          <key>brightwest</key>
          <value>There is a counter in front of you. You can hear grunting nearby. You cannot see the trail of blood from here.</value>
        </item>
      </descriptions>
      <bloodTrail type="boolean">false</bloodTrail>
      <description type="script">
        PrintRoomDesc (False)
      </description>
      <exit name="North108" alias="north" to="defaultroom">
        <inherit name="northdirection" />
        <runscript />
        <script type="script">
          MoveAndFace (kitchen72, 0)
        </script>
      </exit>
      <exit name="South108" alias="south" to="defaultroom">
        <inherit name="southdirection" />
        <runscript />
        <script type="script">
          MoveAndFace (kitchen74, 2)
        </script>
      </exit>
    </object>
    <object name="kitchen74">
      <inherit name="editor_room" />
      <usedefaultprefix />
      <descriptions type="stringdictionary">
        <item>
          <key>darknorth</key>
          <value>You cannot see anything. </value>
        </item>
        <item>
          <key>darkeast</key>
          <value>You cannot see anything. </value>
        </item>
        <item>
          <key>darksouth</key>
          <value>You cannot see anything. </value>
        </item>
        <item>
          <key>darkwest</key>
          <value>You cannot see anything. </value>
        </item>
        <item>
          <key>dimnorth</key>
          <value>You cannot see any blood on the ground.</value>
        </item>
        <item>
          <key>dimeast</key>
          <value>You cannot see any blood on the ground.</value>
        </item>
        <item>
          <key>dimsouth</key>
          <value>You cannot see any blood on the ground.</value>
        </item>
        <item>
          <key>dimwest</key>
          <value>You cannot see any blood on the ground.</value>
        </item>
        <item>
          <key>brightnorth</key>
          <value>There is some blood on the ground a step to the east, and a step to the west of you.</value>
        </item>
        <item>
          <key>brighteast</key>
          <value>There is some blood on the ground a step forwards. </value>
        </item>
        <item>
          <key>brightsouth</key>
          <value>There is some blood on the ground a step to the west of you, and a step to the east of you.</value>
        </item>
        <item>
          <key>brightwest</key>
          <value>There is some blood on the ground a step forwards.</value>
        </item>
      </descriptions>
      <bloodTrail type="boolean">false</bloodTrail>
      <description type="script">
        PrintRoomDesc (False)
      </description>
      <exit name="North109" alias="north" to="defaultroom">
        <inherit name="northdirection" />
        <runscript />
        <script type="script">
          MoveAndFace (kitchen73, 0)
        </script>
      </exit>
      <exit name="East109" alias="east" to="defaultroom">
        <inherit name="eastdirection" />
        <runscript />
        <script type="script">
          MoveAndFace (kitchen68, 1)
        </script>
      </exit>
      <exit name="South109" alias="south" to="defaultroom">
        <inherit name="southdirection" />
        <runscript />
        <script type="script">
          MoveAndFace (kitchen75, 2)
        </script>
      </exit>
      <exit name="West109" alias="west" to="defaultroom">
        <inherit name="westdirection" />
        <runscript />
        <visible />
        <script type="script">
          MoveAndFace (kitchen78, 3)
        </script>
      </exit>
    </object>
    <object name="kitchen75">
      <inherit name="editor_room" />
      <usedefaultprefix />
      <descriptions type="stringdictionary">
        <item>
          <key>darknorth</key>
          <value>You cannot see anything. </value>
        </item>
        <item>
          <key>darkeast</key>
          <value>You cannot see anything. You can feel a counter in front of you.</value>
        </item>
        <item>
          <key>darksouth</key>
          <value>You cannot see anything. </value>
        </item>
        <item>
          <key>darkwest</key>
          <value>You cannot see anything. </value>
        </item>
        <item>
          <key>dimnorth</key>
          <value>There is a counter to the east of you. You cannot see any blood on the ground.</value>
        </item>
        <item>
          <key>dimeast</key>
          <value>There is a counter in front of you. You cannot see any blood on the ground.</value>
        </item>
        <item>
          <key>dimsouth</key>
          <value>There is a counter to the east of you. You cannot see any blood on the ground.</value>
        </item>
        <item>
          <key>dimwest</key>
          <value>You cannot see any blood on the ground.</value>
        </item>
        <item>
          <key>brightnorth</key>
          <value>There is a counter to the east of you. You can the trail of blood to the west of you.</value>
        </item>
        <item>
          <key>brighteast</key>
          <value>There is a counter in front of you. You cannot see the trail of blood from here.</value>
        </item>
        <item>
          <key>brightsouth</key>
          <value>There is a counter to the east of you. There is some blood on the ground a few steps forwards, and a step to the west.</value>
        </item>
        <item>
          <key>brightwest</key>
          <value>There is some blood on the ground a step forwards, and a few steps to the south.</value>
        </item>
      </descriptions>
      <bloodTrail type="boolean">false</bloodTrail>
      <description type="script"><![CDATA[
        PrintRoomDesc (False)
        if (not oil2.parent = null and lantern.light_level > 0) {
          if (player.facing_num = 1) {
            msg ("The counter in front of you has a cask of oil sitting on it.")
          }
          else if (player.facing_num <> 3) {
            msg ("The counter to the east has a cask of oil sitting on it.")
          }
        }
      ]]></description>
      <exit name="North110" alias="north" to="defaultroom">
        <inherit name="northdirection" />
        <runscript />
        <script type="script">
          MoveAndFace (kitchen74, 0)
        </script>
      </exit>
      <exit name="South110" alias="south" to="defaultroom">
        <inherit name="southdirection" />
        <runscript />
        <script type="script">
          MoveAndFace (kitchen76, 2)
        </script>
      </exit>
      <exit name="West110" alias="west" to="defaultroom">
        <inherit name="westdirection" />
        <runscript />
        <visible />
        <script type="script">
          MoveAndFace (kitchen79, 3)
        </script>
      </exit>
    </object>
    <object name="kitchen76">
      <inherit name="editor_room" />
      <usedefaultprefix />
      <descriptions type="stringdictionary">
        <item>
          <key>darknorth</key>
          <value>You cannot see anything. </value>
        </item>
        <item>
          <key>darkeast</key>
          <value>You cannot see anything. </value>
        </item>
        <item>
          <key>darksouth</key>
          <value>You cannot see anything. </value>
        </item>
        <item>
          <key>darkwest</key>
          <value>You cannot see anything. </value>
        </item>
        <item>
          <key>dimnorth</key>
          <value>You cannot see any blood on the ground.</value>
        </item>
        <item>
          <key>dimeast</key>
          <value>You cannot see any blood on the ground.</value>
        </item>
        <item>
          <key>dimsouth</key>
          <value>You cannot see any blood on the ground.</value>
        </item>
        <item>
          <key>dimwest</key>
          <value>You cannot see any blood on the ground.</value>
        </item>
        <item>
          <key>brightnorth</key>
          <value>There is some blood on the ground northwest of you.</value>
        </item>
        <item>
          <key>brighteast</key>
          <value>There is some blood on the ground a step to the south of you.</value>
        </item>
        <item>
          <key>brightsouth</key>
          <value>There is some blood on the ground a step forwards.</value>
        </item>
        <item>
          <key>brightwest</key>
          <value>There is some blood on the ground a step to the south of you.</value>
        </item>
      </descriptions>
      <bloodTrail type="boolean">false</bloodTrail>
      <description type="script">
        PrintRoomDesc (False)
      </description>
      <exit name="North111" alias="north" to="defaultroom">
        <inherit name="northdirection" />
        <runscript />
        <script type="script">
          MoveAndFace (kitchen75, 0)
        </script>
      </exit>
      <exit name="East111" alias="east" to="defaultroom">
        <inherit name="eastdirection" />
        <runscript />
        <script type="script">
          MoveAndFace (kitchen69, 1)
        </script>
      </exit>
      <exit name="South111" alias="south" to="defaultroom">
        <inherit name="southdirection" />
        <runscript />
        <script type="script">
          MoveAndFace (kitchen77, 2)
        </script>
      </exit>
      <exit name="West111" alias="west" to="defaultroom">
        <inherit name="westdirection" />
        <runscript />
        <visible />
        <script type="script">
          MoveAndFace (kitchen80, 3)
        </script>
      </exit>
    </object>
    <object name="kitchen77">
      <inherit name="editor_room" />
      <usedefaultprefix />
      <descriptions type="stringdictionary">
        <item>
          <key>darknorth</key>
          <value>You cannot see anything. </value>
        </item>
        <item>
          <key>darkeast</key>
          <value>You cannot see anything. </value>
        </item>
        <item>
          <key>darksouth</key>
          <value>You cannot see anything. You can feel a counter in front of you.</value>
        </item>
        <item>
          <key>darkwest</key>
          <value>You cannot see anything. </value>
        </item>
        <item>
          <key>dimnorth</key>
          <value>There are some spots of blood on the ground.</value>
        </item>
        <item>
          <key>dimeast</key>
          <value>There is a counter to the south of you. There are some spots of blood on the ground.</value>
        </item>
        <item>
          <key>dimsouth</key>
          <value>There is a counter in front of you. There are some spots of blood on the ground.</value>
        </item>
        <item>
          <key>dimwest</key>
          <value>There are some spots of blood on the ground.</value>
        </item>
        <item>
          <key>brightnorth</key>
          <value>The trail of blood on the ground continues to the east of you.</value>
        </item>
        <item>
          <key>brighteast</key>
          <value>There is a counter to the south of you. The trail of blood on the ground continues forwards. </value>
        </item>
        <item>
          <key>brightsouth</key>
          <value>There is a counter in front of you. The trail of blood continues to the east of you.</value>
        </item>
        <item>
          <key>brightwest</key>
          <value>The trail of blood breaks off in front of you.</value>
        </item>
      </descriptions>
      <bloodTrail />
      <description type="script">
        PrintRoomDesc (False)
      </description>
      <exit name="North112" alias="north" to="defaultroom">
        <inherit name="northdirection" />
        <runscript />
        <script type="script">
          MoveAndFace (kitchen76, 0)
        </script>
      </exit>
      <exit name="East112" alias="east" to="defaultroom">
        <inherit name="eastdirection" />
        <runscript />
        <script type="script">
          MoveAndFace (kitchen70, 1)
        </script>
      </exit>
      <exit name="West112" alias="west" to="defaultroom">
        <inherit name="westdirection" />
        <runscript />
        <visible />
        <script type="script">
          MoveAndFace (kitchen81, 3)
        </script>
      </exit>
    </object>
    <object name="kitchen78">
      <inherit name="editor_room" />
      <usedefaultprefix />
      <descriptions type="stringdictionary">
        <item>
          <key>darknorth</key>
          <value>You cannot see anything. You can feel a counter in front of you.</value>
        </item>
        <item>
          <key>darkeast</key>
          <value>You cannot see anything. </value>
        </item>
        <item>
          <key>darksouth</key>
          <value>You cannot see anything. </value>
        </item>
        <item>
          <key>darkwest</key>
          <value>You cannot see anything. </value>
        </item>
        <item>
          <key>dimnorth</key>
          <value>There is a counter in front of you. There are some spots of blood on the ground.</value>
        </item>
        <item>
          <key>dimeast</key>
          <value>There is a counter to the north of you. There are some spots of blood on the ground.</value>
        </item>
        <item>
          <key>dimsouth</key>
          <value>There are some spots of blood on the ground.</value>
        </item>
        <item>
          <key>dimwest</key>
          <value>There is a counter to the north of you. There are some spots of blood on the ground.</value>
        </item>
        <item>
          <key>brightnorth</key>
          <value>There is a counter in front of you. The trail of blood breaks off to the east, and west of you.</value>
        </item>
        <item>
          <key>brighteast</key>
          <value>There is a counter to the north of you. The trail of blood continues to the south of you.</value>
        </item>
        <item>
          <key>brightsouth</key>
          <value>The trail of blood continues forwards.</value>
        </item>
        <item>
          <key>brightwest</key>
          <value>There is a counter to the north of you. The trail of blood continues to the south.</value>
        </item>
      </descriptions>
      <bloodTrail />
      <description type="script">
        PrintRoomDesc (False)
      </description>
      <exit name="East113" alias="east" to="defaultroom">
        <inherit name="eastdirection" />
        <runscript />
        <script type="script">
          MoveAndFace (kitchen74, 1)
        </script>
      </exit>
      <exit name="South113" alias="south" to="defaultroom">
        <inherit name="southdirection" />
        <runscript />
        <script type="script">
          MoveAndFace (kitchen79, 2)
        </script>
      </exit>
      <exit name="West113" alias="west" to="defaultroom">
        <inherit name="westdirection" />
        <runscript />
        <visible />
        <script type="script">
          MoveAndFace (kitchen82, 3)
        </script>
      </exit>
    </object>
    <object name="kitchen79">
      <inherit name="editor_room" />
      <usedefaultprefix />
      <descriptions type="stringdictionary">
        <item>
          <key>darknorth</key>
          <value>You cannot see anything. </value>
        </item>
        <item>
          <key>darkeast</key>
          <value>You cannot see anything. </value>
        </item>
        <item>
          <key>darksouth</key>
          <value>You cannot see anything. </value>
        </item>
        <item>
          <key>darkwest</key>
          <value>You cannot see anything. </value>
        </item>
        <item>
          <key>dimnorth</key>
          <value>There are some spots of blood on the ground.</value>
        </item>
        <item>
          <key>dimeast</key>
          <value>There are some spots of blood on the ground.</value>
        </item>
        <item>
          <key>dimsouth</key>
          <value>There are some spots of blood on the ground.</value>
        </item>
        <item>
          <key>dimwest</key>
          <value>There are some spots of blood on the ground.</value>
        </item>
        <item>
          <key>brightnorth</key>
          <value>The trail of blood continues forwards.</value>
        </item>
        <item>
          <key>brighteast</key>
          <value>The trail of blood continues to the north of you, and breaks off to the south.</value>
        </item>
        <item>
          <key>brightsouth</key>
          <value>The trail of blood breaks off in front of you. </value>
        </item>
        <item>
          <key>brightwest</key>
          <value>The trail of blood continues to the north of you, and breaks off to the south.</value>
        </item>
      </descriptions>
      <bloodTrail />
      <description type="script">
        PrintRoomDesc (False)
      </description>
      <exit name="North114" alias="north" to="defaultroom">
        <inherit name="northdirection" />
        <runscript />
        <script type="script">
          MoveAndFace (kitchen78, 0)
        </script>
      </exit>
      <exit name="East114" alias="east" to="defaultroom">
        <inherit name="eastdirection" />
        <runscript />
        <script type="script">
          MoveAndFace (kitchen75, 1)
        </script>
      </exit>
      <exit name="South114" alias="south" to="defaultroom">
        <inherit name="southdirection" />
        <runscript />
        <script type="script">
          MoveAndFace (kitchen80, 2)
        </script>
      </exit>
      <exit name="West114" alias="west" to="defaultroom">
        <inherit name="westdirection" />
        <runscript />
        <visible />
        <script type="script">
          MoveAndFace (kitchen83, 3)
        </script>
      </exit>
    </object>
    <object name="kitchen80">
      <inherit name="editor_room" />
      <usedefaultprefix />
      <descriptions type="stringdictionary">
        <item>
          <key>darknorth</key>
          <value>You cannot see anything. </value>
        </item>
        <item>
          <key>darkeast</key>
          <value>You cannot see anything. </value>
        </item>
        <item>
          <key>darksouth</key>
          <value>You cannot see anything. </value>
        </item>
        <item>
          <key>darkwest</key>
          <value>You cannot see anything. </value>
        </item>
        <item>
          <key>dimnorth</key>
          <value>You cannot see any blood on the ground.</value>
        </item>
        <item>
          <key>dimeast</key>
          <value>You cannot see any blood on the ground.</value>
        </item>
        <item>
          <key>dimsouth</key>
          <value>You cannot see any blood on the ground.</value>
        </item>
        <item>
          <key>dimwest</key>
          <value>You cannot see any blood on the ground.</value>
        </item>
        <item>
          <key>brightnorth</key>
          <value>There is some blood on the ground a step forwards, and a step west of you.</value>
        </item>
        <item>
          <key>brighteast</key>
          <value>There is some blood on the ground to the north of you, and to the southeast of you. </value>
        </item>
        <item>
          <key>brightsouth</key>
          <value>There is some blood on the ground a step to the west of you.</value>
        </item>
        <item>
          <key>brightwest</key>
          <value>There is some blood on the ground a step forwards, and to the north of you.</value>
        </item>
      </descriptions>
      <bloodTrail type="boolean">false</bloodTrail>
      <description type="script">
        PrintRoomDesc (False)
      </description>
      <exit name="North115" alias="north" to="defaultroom">
        <inherit name="northdirection" />
        <runscript />
        <script type="script">
          MoveAndFace (kitchen79, 0)
        </script>
      </exit>
      <exit name="East115" alias="east" to="defaultroom">
        <inherit name="eastdirection" />
        <runscript />
        <script type="script">
          MoveAndFace (kitchen76, 1)
        </script>
      </exit>
      <exit name="South115" alias="south" to="defaultroom">
        <inherit name="southdirection" />
        <runscript />
        <script type="script">
          MoveAndFace (kitchen81, 2)
        </script>
      </exit>
      <exit name="West115" alias="west" to="defaultroom">
        <inherit name="westdirection" />
        <runscript />
        <visible />
        <script type="script">
          MoveAndFace (kitchen84, 3)
        </script>
      </exit>
    </object>
    <object name="kitchen81">
      <inherit name="editor_room" />
      <usedefaultprefix />
      <descriptions type="stringdictionary">
        <item>
          <key>darknorth</key>
          <value>You cannot see anything. </value>
        </item>
        <item>
          <key>darkeast</key>
          <value>You cannot see anything. </value>
        </item>
        <item>
          <key>darksouth</key>
          <value>You cannot see anything. You can feel a counter in front of you.</value>
        </item>
        <item>
          <key>darkwest</key>
          <value>You cannot see anything. </value>
        </item>
        <item>
          <key>dimnorth</key>
          <value>You cannot see any blood on the ground.</value>
        </item>
        <item>
          <key>dimeast</key>
          <value>There is a counter to the south of you. You cannot see any blood on the ground.</value>
        </item>
        <item>
          <key>dimsouth</key>
          <value>There is a counter in front of you. You cannot see any blood on the ground.</value>
        </item>
        <item>
          <key>dimwest</key>
          <value>There is a counter to the south of you. You cannot see any blood on the ground.</value>
        </item>
        <item>
          <key>brightnorth</key>
          <value>The trail of blood is a step to the west, and a step to the east of you.</value>
        </item>
        <item>
          <key>brighteast</key>
          <value>There is a trail of blood a step forwards.</value>
        </item>
        <item>
          <key>brightsouth</key>
          <value>There is a counter in front of you. There is a trail of blood a step to the west, and to the east of you.</value>
        </item>
        <item>
          <key>brightwest</key>
          <value>There is a counter to the south of you. There is some blood on the ground a step forwards.</value>
        </item>
      </descriptions>
      <bloodTrail type="boolean">false</bloodTrail>
      <description type="script">
        PrintRoomDesc (False)
      </description>
      <exit name="North116" alias="north" to="defaultroom">
        <inherit name="northdirection" />
        <runscript />
        <script type="script">
          MoveAndFace (kitchen80, 0)
        </script>
      </exit>
      <exit name="East116" alias="east" to="defaultroom">
        <inherit name="eastdirection" />
        <runscript />
        <script type="script">
          MoveAndFace (kitchen77, 1)
        </script>
      </exit>
      <exit name="West116" alias="west" to="defaultroom">
        <inherit name="westdirection" />
        <runscript />
        <visible />
        <script type="script">
          MoveAndFace (kitchen85, 3)
        </script>
      </exit>
    </object>
    <object name="kitchen82">
      <inherit name="editor_room" />
      <usedefaultprefix />
      <descriptions type="stringdictionary">
        <item>
          <key>darknorth</key>
          <value>You cannot see anything. You can feel a counter in front of you.</value>
        </item>
        <item>
          <key>darkeast</key>
          <value>You cannot see anything. </value>
        </item>
        <item>
          <key>darksouth</key>
          <value>You cannot see anything. </value>
        </item>
        <item>
          <key>darkwest</key>
          <value>You cannot see anything. </value>
        </item>
        <item>
          <key>dimnorth</key>
          <value>There is a counter in front of you. You cannot see any blood on the ground.</value>
        </item>
        <item>
          <key>dimeast</key>
          <value>There is a counter to the north of you. You cannot see any blood on the ground.</value>
        </item>
        <item>
          <key>dimsouth</key>
          <value>You cannot see any blood on the ground.</value>
        </item>
        <item>
          <key>dimwest</key>
          <value>There is a counter to the north of you. The ground a step forwards looks weird. You cannot see any blood on the ground.</value>
        </item>
        <item>
          <key>brightnorth</key>
          <value>There is a counter in front of you. You can see some blood on the ground a step to the east.</value>
        </item>
        <item>
          <key>brighteast</key>
          <value>There is a counter to the north of you. There is some blood on the ground a step forwards, and a few steps to the south. </value>
        </item>
        <item>
          <key>brightsouth</key>
          <value>You can see some blood on the ground a few steps forwards.</value>
        </item>
        <item>
          <key>brightwest</key>
          <value>There is a counter to the north of you. The ground a step forwards looks unstable. You can see some blood on the ground a few steps to the south. </value>
        </item>
      </descriptions>
      <bloodTrail type="boolean">false</bloodTrail>
      <description type="script">
        PrintRoomDesc (False)
      </description>
      <exit name="East117" alias="east" to="defaultroom">
        <inherit name="eastdirection" />
        <runscript />
        <script type="script">
          MoveAndFace (kitchen78, 1)
        </script>
      </exit>
      <exit name="South117" alias="south" to="defaultroom">
        <inherit name="southdirection" />
        <runscript />
        <script type="script">
          MoveAndFace (kitchen83, 2)
        </script>
      </exit>
      <exit name="West117" alias="west" to="defaultroom">
        <inherit name="westdirection" />
        <runscript />
        <visible />
        <script type="script">
          MoveAndFace (kitchen86, 3)
        </script>
      </exit>
    </object>
    <object name="kitchen83">
      <inherit name="editor_room" />
      <usedefaultprefix />
      <descriptions type="stringdictionary">
        <item>
          <key>darknorth</key>
          <value>You cannot see anything. </value>
        </item>
        <item>
          <key>darkeast</key>
          <value>You cannot see anything. </value>
        </item>
        <item>
          <key>darksouth</key>
          <value>You cannot see anything. </value>
        </item>
        <item>
          <key>darkwest</key>
          <value>You cannot see anything. </value>
        </item>
        <item>
          <key>dimnorth</key>
          <value>You cannot see any blood on the ground.</value>
        </item>
        <item>
          <key>dimeast</key>
          <value>You cannot see any blood on the ground.</value>
        </item>
        <item>
          <key>dimsouth</key>
          <value>You cannot see any blood on the ground.</value>
        </item>
        <item>
          <key>dimwest</key>
          <value>You cannot see any blood on the ground.</value>
        </item>
        <item>
          <key>brightnorth</key>
          <value>There is some blood on the ground a step east of you.</value>
        </item>
        <item>
          <key>brighteast</key>
          <value>There is some blood on the ground a step forwards, and a step to the west of you.</value>
        </item>
        <item>
          <key>brightsouth</key>
          <value>There is some blood on the ground a step forwards, and a step to the east of you. </value>
        </item>
        <item>
          <key>brightwest</key>
          <value>There is some blood on the ground a step to the south of you.</value>
        </item>
      </descriptions>
      <bloodTrail type="boolean">false</bloodTrail>
      <description type="script">
        PrintRoomDesc (False)
      </description>
      <exit name="North118" alias="north" to="defaultroom">
        <inherit name="northdirection" />
        <runscript />
        <script type="script">
          MoveAndFace (kitchen82, 0)
        </script>
      </exit>
      <exit name="East118" alias="east" to="defaultroom">
        <inherit name="eastdirection" />
        <runscript />
        <script type="script">
          MoveAndFace (kitchen79, 1)
        </script>
      </exit>
      <exit name="South118" alias="south" to="defaultroom">
        <inherit name="southdirection" />
        <runscript />
        <script type="script">
          MoveAndFace (kitchen84, 2)
        </script>
      </exit>
      <exit name="West118" alias="west" to="defaultroom">
        <inherit name="westdirection" />
        <runscript />
        <visible />
        <script type="script">
          MoveAndFace (kitchen87, 3)
        </script>
      </exit>
    </object>
    <object name="kitchen84">
      <inherit name="editor_room" />
      <usedefaultprefix />
      <descriptions type="stringdictionary">
        <item>
          <key>darknorth</key>
          <value>You cannot see anything. </value>
        </item>
        <item>
          <key>darkeast</key>
          <value>You cannot see anything. </value>
        </item>
        <item>
          <key>darksouth</key>
          <value>You cannot see anything. </value>
        </item>
        <item>
          <key>darkwest</key>
          <value>You cannot see anything. </value>
        </item>
        <item>
          <key>dimnorth</key>
          <value>There are some spots of blood on the ground.</value>
        </item>
        <item>
          <key>dimeast</key>
          <value>There are some spots of blood on the ground.</value>
        </item>
        <item>
          <key>dimsouth</key>
          <value>There are some spots of blood on the ground.</value>
        </item>
        <item>
          <key>dimwest</key>
          <value>There are some spots of blood on the ground.</value>
        </item>
        <item>
          <key>brightnorth</key>
          <value>The trail of blood on the ground breaks off in front of you.</value>
        </item>
        <item>
          <key>brighteast</key>
          <value>The trail of blood on the ground continues to the south of you.</value>
        </item>
        <item>
          <key>brightsouth</key>
          <value>The trail of blood on the ground continues forwards.</value>
        </item>
        <item>
          <key>brightwest</key>
          <value>The trail of blood on the ground continues to the south of you. </value>
        </item>
      </descriptions>
      <bloodTrail />
      <description type="script">
        PrintRoomDesc (False)
      </description>
      <exit name="North119" alias="north" to="defaultroom">
        <inherit name="northdirection" />
        <runscript />
        <script type="script">
          MoveAndFace (kitchen83, 0)
        </script>
      </exit>
      <exit name="East119" alias="east" to="defaultroom">
        <inherit name="eastdirection" />
        <runscript />
        <script type="script">
          MoveAndFace (kitchen80, 1)
        </script>
      </exit>
      <exit name="South119" alias="south" to="defaultroom">
        <inherit name="southdirection" />
        <runscript />
        <script type="script">
          MoveAndFace (kitchen85, 2)
        </script>
      </exit>
      <exit name="West119" alias="west" to="defaultroom">
        <inherit name="westdirection" />
        <runscript />
        <visible />
        <script type="script">
          MoveAndFace (kitchen88, 3)
        </script>
      </exit>
    </object>
    <object name="kitchen85">
      <inherit name="editor_room" />
      <usedefaultprefix />
      <descriptions type="stringdictionary">
        <item>
          <key>darknorth</key>
          <value>You cannot see anything. </value>
        </item>
        <item>
          <key>darkeast</key>
          <value>You cannot see anything. </value>
        </item>
        <item>
          <key>darksouth</key>
          <value>You cannot see anything. You can feel a counter in front of you.</value>
        </item>
        <item>
          <key>darkwest</key>
          <value>You cannot see anything. </value>
        </item>
        <item>
          <key>dimnorth</key>
          <value>There are some spots of blood on the ground.</value>
        </item>
        <item>
          <key>dimeast</key>
          <value>There is a counter to the south of you. There are some spots of blood on the ground.</value>
        </item>
        <item>
          <key>dimsouth</key>
          <value>There is a counter in front of you. There are some spots of blood on the ground.</value>
        </item>
        <item>
          <key>dimwest</key>
          <value>There is a counter to the south of you. There are some spots of blood on the ground.</value>
        </item>
        <item>
          <key>brightnorth</key>
          <value>The trail of blood continues forwards.</value>
        </item>
        <item>
          <key>brighteast</key>
          <value>There is a counter to the south of you. The trail of blood continues to the east of you, and breaks off to the east. You think you can see some blood on the ground a few steps ahead, but it is hard to tell.</value>
        </item>
        <item>
          <key>brightsouth</key>
          <value>There is a counter in front of you. The trail of blood breaks off to the east of you.</value>
        </item>
        <item>
          <key>brightwest</key>
          <value>There is a counter to the south of you. The trail of blood continues to the north of you.</value>
        </item>
      </descriptions>
      <bloodTrail />
      <description type="script">
        PrintRoomDesc (False)
      </description>
      <exit name="North120" alias="north" to="defaultroom">
        <inherit name="northdirection" />
        <runscript />
        <script type="script">
          MoveAndFace (kitchen84, 0)
        </script>
      </exit>
      <exit name="East120" alias="east" to="defaultroom">
        <inherit name="eastdirection" />
        <runscript />
        <script type="script">
          MoveAndFace (kitchen81, 1)
        </script>
      </exit>
      <exit name="West120" alias="west" to="defaultroom">
        <inherit name="westdirection" />
        <runscript />
        <visible />
        <script type="script">
          MoveAndFace (kitchen89, 3)
        </script>
      </exit>
    </object>
    <object name="kitchen86">
      <inherit name="editor_room" />
      <usedefaultprefix />
      <descriptions type="stringdictionary">
        <item>
          <key>darknorth</key>
          <value>TODO: implement this description</value>
        </item>
        <item>
          <key>darkeast</key>
          <value>TODO: implement this description</value>
        </item>
        <item>
          <key>darksouth</key>
          <value>TODO: implement this description</value>
        </item>
        <item>
          <key>darkwest</key>
          <value>TODO: implement this description</value>
        </item>
        <item>
          <key>dimnorth</key>
          <value>TODO: implement this description</value>
        </item>
        <item>
          <key>dimeast</key>
          <value>TODO: implement this description</value>
        </item>
        <item>
          <key>dimsouth</key>
          <value>TODO: implement this description</value>
        </item>
        <item>
          <key>dimwest</key>
          <value>TODO: implement this description</value>
        </item>
        <item>
          <key>brightnorth</key>
          <value>TODO: implement this description</value>
        </item>
        <item>
          <key>brighteast</key>
          <value>TODO: implement this description</value>
        </item>
        <item>
          <key>brightsouth</key>
          <value>TODO: implement this description</value>
        </item>
        <item>
          <key>brightwest</key>
          <value>TODO: implement this description</value>
        </item>
      </descriptions>
      <bloodTrail type="boolean">false</bloodTrail>
      <description type="script">
        msg ("Your foot gets caught in a hole on the ground, causing you to tumble into the countertop. You crash into all sorts of utensils, and your lantern rolls across the counter staying lit. You see something move on the other side of the counter. You hear what begins as a low rumble, and progressively getting louder, turns into a roar.")
        msg ("The lantern rolls off the other side of the counter, falls to the ground, and shatters. It leaks oil all over the floor, and in the process lights it all on fire. You can see now what is on the other side of the counter.")
        msg ("There are no words. It is a huge, and wide creature, made of shadows and dripping blood. All you can see in the mass of shadows is a fanged mouth, filled with sharp talons for teeth. It is wielding a large butchers knife, covered in the blood and guts of the meat surrounding him.")
        msg ("It charges.")
        msg ("You close your eyes.")
        Die
      </description>
      <exit name="East121" alias="east" to="defaultroom">
        <inherit name="eastdirection" />
        <runscript />
        <script type="script">
          MoveAndFace (kitchen82, 1)
        </script>
      </exit>
      <exit name="South121" alias="south" to="defaultroom">
        <inherit name="southdirection" />
        <runscript />
        <script type="script">
          MoveAndFace (kitchen87, 2)
        </script>
      </exit>
    </object>
    <object name="kitchen87">
      <inherit name="editor_room" />
      <usedefaultprefix />
      <descriptions type="stringdictionary">
        <item>
          <key>darknorth</key>
          <value>You cannot see anything. </value>
        </item>
        <item>
          <key>darkeast</key>
          <value>You cannot see anything. </value>
        </item>
        <item>
          <key>darksouth</key>
          <value>You cannot see anything. </value>
        </item>
        <item>
          <key>darkwest</key>
          <value>You cannot see anything. You can feel a wall in front of you.</value>
        </item>
        <item>
          <key>dimnorth</key>
          <value>There is a wall to the west of you. The ground a step forwards looks weird. You cannot see any blood on the ground.</value>
        </item>
        <item>
          <key>dimeast</key>
          <value>The ground to the north of you looks weird. You cannot see any blood on the ground.</value>
        </item>
        <item>
          <key>dimsouth</key>
          <value>There is a wall to the west of you. You cannot see any blood on the ground.</value>
        </item>
        <item>
          <key>dimwest</key>
          <value>There is a wall in front of you. You cannot see any blood on the ground.</value>
        </item>
        <item>
          <key>brightnorth</key>
          <value>There is a wall to the west of you. The ground a step forwards looks unstable. You cannot see the trail of blood from here.</value>
        </item>
        <item>
          <key>brighteast</key>
          <value>The ground to the north of you looks unstable. There is some blood on the ground to the southeast. </value>
        </item>
        <item>
          <key>brightsouth</key>
          <value>There is a wall to the west of you. There is some blood on the ground to the southeast.</value>
        </item>
        <item>
          <key>brightwest</key>
          <value>There is a wall in front of you. You cannot see the trail of blood from here. </value>
        </item>
      </descriptions>
      <bloodTrail type="boolean">false</bloodTrail>
      <description type="script">
        PrintRoomDesc (False)
      </description>
      <exit name="North122" alias="north" to="defaultroom">
        <inherit name="northdirection" />
        <runscript />
        <script type="script">
          MoveAndFace (kitchen86, 0)
        </script>
      </exit>
      <exit name="East122" alias="east" to="defaultroom">
        <inherit name="eastdirection" />
        <runscript />
        <script type="script">
          MoveAndFace (kitchen83, 1)
        </script>
      </exit>
      <exit name="South122" alias="south" to="defaultroom">
        <inherit name="southdirection" />
        <runscript />
        <script type="script">
          MoveAndFace (kitchen88, 2)
        </script>
      </exit>
    </object>
    <object name="kitchen88">
      <inherit name="editor_room" />
      <usedefaultprefix />
      <descriptions type="stringdictionary">
        <item>
          <key>darknorth</key>
          <value>You cannot see anything. </value>
        </item>
        <item>
          <key>darkeast</key>
          <value>You cannot see anything. </value>
        </item>
        <item>
          <key>darksouth</key>
          <value>You cannot see anything. </value>
        </item>
        <item>
          <key>darkwest</key>
          <value>You cannot see anything. You can feel a wall in front of you.</value>
        </item>
        <item>
          <key>dimnorth</key>
          <value>There is a wall to the west of you. You cannot see any blood on the ground.</value>
        </item>
        <item>
          <key>dimeast</key>
          <value>You cannot see any blood on the ground.</value>
        </item>
        <item>
          <key>dimsouth</key>
          <value>There is a wall to the west of you. You cannot see any blood on the ground.</value>
        </item>
        <item>
          <key>dimwest</key>
          <value>There is a wall in front of you. You cannot see any blood on the ground.</value>
        </item>
        <item>
          <key>brightnorth</key>
          <value>There is a wall to the west of you. There is some blood on the ground to the east of you.</value>
        </item>
        <item>
          <key>brighteast</key>
          <value>There is some blood on the ground a step forwards.</value>
        </item>
        <item>
          <key>brightsouth</key>
          <value>There is a wall to the west of you. There is some blood on the ground a step to the east of you.</value>
        </item>
        <item>
          <key>brightwest</key>
          <value>There is a wall in front of you. You cannot see the trail of blood from here.</value>
        </item>
      </descriptions>
      <bloodTrail type="boolean">false</bloodTrail>
      <description type="script">
        PrintRoomDesc (False)
      </description>
      <exit name="South36" alias="south" to="defaultroom">
        <inherit name="southdirection" />
        <runscript />
        <script type="script">
          MoveAndFace (kitchen89, 2)
        </script>
      </exit>
      <exit name="East38" alias="east" to="defaultroom">
        <inherit name="eastdirection" />
        <runscript />
        <script type="script">
          MoveAndFace (kitchen84, 1)
        </script>
      </exit>
      <exit name="North14" alias="north" to="defaultroom">
        <inherit name="northdirection" />
        <runscript />
        <script type="script">
          MoveAndFace (kitchen87, 0)
        </script>
      </exit>
    </object>
    <object name="kitchen89">
      <inherit name="editor_room" />
      <usedefaultprefix />
      <descriptions type="stringdictionary">
        <item>
          <key>darknorth</key>
          <value>You cannot see anything. </value>
        </item>
        <item>
          <key>darkeast</key>
          <value>You cannot see anything. </value>
        </item>
        <item>
          <key>darksouth</key>
          <value>You cannot see anything. You can feel a counter in front of you.</value>
        </item>
        <item>
          <key>darkwest</key>
          <value>You cannot see anything. You can feel a wall in front of you.</value>
        </item>
        <item>
          <key>dimnorth</key>
          <value>There is a wall to the west of you. You cannot see any blood on the ground.</value>
        </item>
        <item>
          <key>dimeast</key>
          <value>There is a counter to the south of you. You cannot see any blood on the ground.</value>
        </item>
        <item>
          <key>dimsouth</key>
          <value>There is a counter in front of you. There is a wall to the west of you. You cannot see any blood on the ground.</value>
        </item>
        <item>
          <key>dimwest</key>
          <value>There is a wall in front of you. There is a counter to the south of you. You cannot see any blood on the ground.</value>
        </item>
        <item>
          <key>brightnorth</key>
          <value>There is a wall to the west of you. You can see some blood on the ground to the east of you. </value>
        </item>
        <item>
          <key>brighteast</key>
          <value>There is a counter to the south of you. There is some blood on the ground a step forwards.</value>
        </item>
        <item>
          <key>brightsouth</key>
          <value>There is counter in front of you. There is a wall to the west of you. There is some blood on the ground to the east of you. </value>
        </item>
        <item>
          <key>brightwest</key>
          <value>There is a wall in front of you. There is a counter to the south of you. You cannot see the trail of blood from here.  </value>
        </item>
      </descriptions>
      <bloodTrail type="boolean">false</bloodTrail>
      <description type="script"><![CDATA[
        PrintRoomDesc (False)
        if (not oil3.parent = null and lantern.light_level > 0) {
          if (player.facing_num = 2) {
            msg ("The counter in front of you has a cask of oil sitting on it.")
          }
          else if (player.facing_num <> 0) {
            msg ("The counter to the south has a cask of oil sitting on it.")
          }
        }
      ]]></description>
      <exit name="East46" alias="east" to="defaultroom">
        <inherit name="eastdirection" />
        <runscript />
        <script type="script">
          MoveAndFace (kitchen85, 1)
        </script>
      </exit>
      <exit name="North15" alias="north" to="defaultroom">
        <inherit name="northdirection" />
        <runscript />
        <script type="script">
          MoveAndFace (kitchen88, 0)
        </script>
      </exit>
      <object name="oil3">
        <inherit name="editor_object" />
        <alt type="stringlist">
          <value>cask</value>
        </alt>
        <alias>oil</alias>
        <scenery />
        <feature_usegive />
        <take type="script">
          GetOil (oil3)
        </take>
        <use type="script">
          GetOil (oil3)
        </use>
      </object>
    </object>
  </object>
  <object name="nursery">
    <inherit name="editor_object" />
    <darknessTimer type="int">0</darknessTimer>
    <object name="nursery1">
      <inherit name="editor_room" />
      <usedefaultprefix />
      <descriptions type="stringdictionary">
        <item>
          <key>darknorth</key>
          <value>You cannot see anything.</value>
        </item>
        <item>
          <key>darkeast</key>
          <value>You cannot see anything. You can feel a wall in front of you.</value>
        </item>
        <item>
          <key>darksouth</key>
          <value>You cannot see anything.</value>
        </item>
        <item>
          <key>darkwest</key>
          <value>You cannot see anything. You can feel a wall in front of you.</value>
        </item>
        <item>
          <key>dimnorth</key>
          <value>You are in a narrow hallway, there is a wall to the east, and to the west of you. </value>
        </item>
        <item>
          <key>dimeast</key>
          <value>You are in a narrow hallway, there is a wall in front of you.</value>
        </item>
        <item>
          <key>dimsouth</key>
          <value>You are in a narrow hallway, there is a wall to the east, and to the west of you. </value>
        </item>
        <item>
          <key>dimwest</key>
          <value>You are in a narrow hallway, there is a wall in front of you.</value>
        </item>
        <item>
          <key>brightnorth</key>
          <value>You are in a narrow hallway, there is a wall to the east, and to the west of you. </value>
        </item>
        <item>
          <key>brighteast</key>
          <value>You are in a narrow hallway, there is a wall in front of you.</value>
        </item>
        <item>
          <key>brightsouth</key>
          <value>You are in a narrow hallway, there is a wall to the east, and to the west of you.</value>
        </item>
        <item>
          <key>brightwest</key>
          <value>You are in a narrow hallway, there is a wall in front of you.</value>
        </item>
      </descriptions>
      <description type="script">
        PrintRoomDesc (False)
      </description>
      <firstenter type="script">
        EnableTurnScript (nursery_turn_script)
      </firstenter>
      <exit name="North33" alias="north" to="defaultroom">
        <inherit name="northdirection" />
        <runscript />
        <script type="script">
          MoveAndFace (nursery2, 0)
        </script>
      </exit>
      <exit name="South37" alias="south" to="defaultroom">
        <inherit name="southdirection" />
        <runscript />
        <locked />
        <script type="script">
          MoveAndFace (hub3, 2)
        </script>
      </exit>
    </object>
    <object name="nursery2">
      <inherit name="editor_room" />
      <usedefaultprefix />
      <descriptions type="stringdictionary">
        <item>
          <key>darknorth</key>
          <value>You cannot see anything.</value>
        </item>
        <item>
          <key>darkeast</key>
          <value>You cannot see anything. You can feel a wall in front of you.</value>
        </item>
        <item>
          <key>darksouth</key>
          <value>You cannot see anything.</value>
        </item>
        <item>
          <key>darkwest</key>
          <value>You cannot see anything. You can feel a wall in front of you.</value>
        </item>
        <item>
          <key>dimnorth</key>
          <value>You are in a narrow hallway, there is a wall to the east, and to the west of you.</value>
        </item>
        <item>
          <key>dimeast</key>
          <value>You are in a narrow hallway, there is a wall in front of you.</value>
        </item>
        <item>
          <key>dimsouth</key>
          <value>You are in a narrow hallway, there is a wall to the east, and to the west of you.</value>
        </item>
        <item>
          <key>dimwest</key>
          <value>You are in a narrow hallway, there is a wall in front of you.</value>
        </item>
        <item>
          <key>brightnorth</key>
          <value>You are in a narrow hallway, there is a wall to the east, and to the west of you.</value>
        </item>
        <item>
          <key>brighteast</key>
          <value>You are in a narrow hallway, there is a wall in front of you.</value>
        </item>
        <item>
          <key>brightsouth</key>
          <value>You are in a narrow hallway, there is a wall to the east, and to the west of you.</value>
        </item>
        <item>
          <key>brightwest</key>
          <value>You are in a narrow hallway, there is a wall in front of you.</value>
        </item>
      </descriptions>
      <description type="script">
        PrintRoomDesc (False)
      </description>
      <exit name="North40" alias="north" to="defaultroom">
        <inherit name="northdirection" />
        <runscript />
        <script type="script">
          MoveAndFace (nursery5, 0)
        </script>
      </exit>
      <exit name="South39" alias="south" to="defaultroom">
        <inherit name="southdirection" />
        <runscript />
        <script type="script">
          MoveAndFace (nursery1, 2)
        </script>
      </exit>
    </object>
    <object name="nursery3">
      <inherit name="editor_room" />
      <usedefaultprefix />
      <descriptions type="stringdictionary">
        <item>
          <key>darknorth</key>
          <value>You cannot see anything.</value>
        </item>
        <item>
          <key>darkeast</key>
          <value>You cannot see anything. You can feel a wall in front of you. You hand brushes through what feels like cobwebs, and it sticks to you. You wipe it off, but, no matter what you do, it feels like it is still there.</value>
        </item>
        <item>
          <key>darksouth</key>
          <value>You cannot see anything. You can feel a wall in front of you.</value>
        </item>
        <item>
          <key>darkwest</key>
          <value>You cannot see anything. You can feel a dusty piece of furniture in front of you.</value>
        </item>
        <item>
          <key>dimnorth</key>
          <value>There is a wall to the east of you, and a dresser to the west. </value>
        </item>
        <item>
          <key>dimeast</key>
          <value>There is a wall in front of you. </value>
        </item>
        <item>
          <key>dimsouth</key>
          <value>There is a wall in front of you, and a dresser to the west.</value>
        </item>
        <item>
          <key>dimwest</key>
          <value>There is a dresser in front of you. </value>
        </item>
        <item>
          <key>brightnorth</key>
          <value>There is a wall to the east of you, and a dresser to the west. The dresser is covered in a thick film of dust. </value>
        </item>
        <item>
          <key>brighteast</key>
          <value>There is a wall in front of you. The wall is covered in cobwebs, you think you see a large spider dart into the corner.</value>
        </item>
        <item>
          <key>brightsouth</key>
          <value>There is a wall in front of you, and a dresser to the west. It is covered in a thick film of dust.</value>
        </item>
        <item>
          <key>brightwest</key>
          <value>There is a dresser in front of you, it is covered in a thick film of dust.</value>
        </item>
      </descriptions>
      <description type="script">
        PrintRoomDesc (False)
      </description>
      <exit name="North42" alias="north" to="defaultroom">
        <inherit name="northdirection" />
        <runscript />
        <script type="script">
          MoveAndFace (nursery6, 0)
        </script>
      </exit>
    </object>
    <object name="nursery4">
      <inherit name="editor_room" />
      <usedefaultprefix />
      <descriptions type="stringdictionary">
        <item>
          <key>darknorth</key>
          <value>You cannot see anything.</value>
        </item>
        <item>
          <key>darkeast</key>
          <value>You cannot see anything. You can feel some kind of piece of furniture in front of you. Your hand is covered in dust from touching it.</value>
        </item>
        <item>
          <key>darksouth</key>
          <value>You cannot see anything. You can feel a wall in front of you.</value>
        </item>
        <item>
          <key>darkwest</key>
          <value>You cannot see anything. You can feel a wall in front of you.</value>
        </item>
        <item>
          <key>dimnorth</key>
          <value>There is a dresser to the south of you, and a wall to the west.</value>
        </item>
        <item>
          <key>dimeast</key>
          <value>There is a dresser in front of you, and a wall to the south of you.</value>
        </item>
        <item>
          <key>dimsouth</key>
          <value>There is a wall in front of you, and a dresser to the east. </value>
        </item>
        <item>
          <key>dimwest</key>
          <value>There is a wall in front of you, and a wall to the south of you.</value>
        </item>
        <item>
          <key>brightnorth</key>
          <value>There is a dresser to the south of you, and a wall to the west. The dresser is covered in a thick film of dust. There is a small bed a few steps north of you.</value>
        </item>
        <item>
          <key>brighteast</key>
          <value>There is a dresser in front of you, and a wall to the south. The dresser is covered in a thick film of dust. </value>
        </item>
        <item>
          <key>brightsouth</key>
          <value>There is a wall in front of you, and a dresser to the east. The dresser is covered in a thick film of dust. </value>
        </item>
        <item>
          <key>brightwest</key>
          <value>There is a wall in front of you, and a wall to the south of you.</value>
        </item>
      </descriptions>
      <description type="script">
        PrintRoomDesc (False)
      </description>
      <exit name="North44" alias="north" to="defaultroom">
        <inherit name="northdirection" />
        <runscript />
        <script type="script">
          MoveAndFace (nursery9, 0)
        </script>
      </exit>
    </object>
    <object name="nursery5">
      <inherit name="editor_room" />
      <usedefaultprefix />
      <descriptions type="stringdictionary">
        <item>
          <key>darknorth</key>
          <value>You cannot see anything.</value>
        </item>
        <item>
          <key>darkeast</key>
          <value>You cannot see anything. You can feel a wall in front of you.</value>
        </item>
        <item>
          <key>darksouth</key>
          <value>You cannot see anything.</value>
        </item>
        <item>
          <key>darkwest</key>
          <value>You cannot see anything. You can feel a hard surface in front of you.</value>
        </item>
        <item>
          <key>dimnorth</key>
          <value>You are in a narrow hallway, there is a wall to the east of you, and a door to the west.</value>
        </item>
        <item>
          <key>dimeast</key>
          <value>You are in a narrow hallway, there is a wall in front of you.</value>
        </item>
        <item>
          <key>dimsouth</key>
          <value>You are in a narrow hallway, there is a wall to the east of you, and a door to the west.</value>
        </item>
        <item>
          <key>dimwest</key>
          <value>You are in a narrow hallway, there is a door in front of you. </value>
        </item>
        <item>
          <key>brightnorth</key>
          <value>You are in a narrow hallway, there is a wall to the east of you, and a door to the west. </value>
        </item>
        <item>
          <key>brighteast</key>
          <value>You are in a narrow hallway, there is a wall in front of you.</value>
        </item>
        <item>
          <key>brightsouth</key>
          <value>You are in a narrow hallway, there is a wall to the east of you, and a door to the west.</value>
        </item>
        <item>
          <key>brightwest</key>
          <value>You are in a narrow hallway, there is a door in front of you.</value>
        </item>
      </descriptions>
      <door_closed />
      <description type="script">
        PrintRoomDesc (False)
      </description>
      <exit name="North46" alias="north" to="defaultroom">
        <inherit name="northdirection" />
        <runscript />
        <script type="script">
          MoveAndFace (nursery12, 0)
        </script>
      </exit>
      <exit name="South45" alias="south" to="defaultroom">
        <inherit name="southdirection" />
        <runscript />
        <script type="script">
          MoveAndFace (nursery2, 2)
        </script>
      </exit>
      <exit name="West64" alias="west" to="defaultroom">
        <inherit name="westdirection" />
        <runscript />
        <visible />
        <script type="script">
          if (nursery5.door_closed) {
            msg ("A closed door blocks your way.")
          }
          else {
            MoveAndFace (nursery6, 3)
            Laila.paused = True
            if (game.debug) {
              msg ("DEBUG: pause Laila")
            }
          }
        </script>
      </exit>
      <command name="Open door2">
        <pattern type="string">(open|push|kick|hit|punch) door</pattern>
        <script>
          if (nursery5.door_closed) {
            msg ("The door swings open.")
            nursery5.door_closed = False
          }
          else {
            msg ("The door is already open.")
          }
        </script>
      </command>
      <command name="Shut door2">
        <pattern type="string">(close|shut) door</pattern>
        <script>
          if (nursery5.door_closed) {
            msg ("The door is already closed.")
          }
          else {
            nursery5.door_closed = True
            msg ("You close the door.")
          }
        </script>
      </command>
    </object>
    <object name="nursery6">
      <inherit name="editor_room" />
      <usedefaultprefix />
      <descriptions type="stringdictionary">
        <item>
          <key>darknorth</key>
          <value>You cannot see anything. You can feel a piece of furniture in front of you, perhaps a table of some kind.</value>
        </item>
        <item>
          <key>darkeast</key>
          <value>You cannot see anything. You can feel something in front of you.</value>
        </item>
        <item>
          <key>darksouth</key>
          <value>You cannot see anything.</value>
        </item>
        <item>
          <key>darkwest</key>
          <value>You cannot see anything.</value>
        </item>
        <item>
          <key>dimnorth</key>
          <value>There is a small table in front of you. There is a door to the east of you. </value>
        </item>
        <item>
          <key>dimeast</key>
          <value>There is a door in front of you, and a table to the north of you. </value>
        </item>
        <item>
          <key>dimsouth</key>
          <value>There is a door to the east of you.</value>
        </item>
        <item>
          <key>dimwest</key>
          <value>There is a table to the north of you.</value>
        </item>
        <item>
          <key>brightnorth</key>
          <value>There is a small table in front of you, there are some old papers scattered on it, but nothing peaks your interest. There is a door to the east of you.</value>
        </item>
        <item>
          <key>brighteast</key>
          <value>There is a door in front of you, and a table to the north of you. The table has some old papers scattered on it, but nothing peaks your interest. </value>
        </item>
        <item>
          <key>brightsouth</key>
          <value>There is a door to the east of you, and a dresser to the southwest of you.</value>
        </item>
        <item>
          <key>brightwest</key>
          <value>There is a table to the north of you.</value>
        </item>
      </descriptions>
      <description type="script"><![CDATA[
        PrintRoomDesc (False)
        if (nursery14.maven_here and lantern.light_level <> 0) {
          if (player.facing_num = 0) {
            msg ("There is some kind of translucent glimmer a few steps northwest of you.")
          }
          else if (player.facing_num = 3) {
            msg ("There is some kind of translucent glimmer a few steps northwest of you.")
          }
        }
      ]]></description>
      <exit name="East66" alias="east" to="defaultroom">
        <inherit name="eastdirection" />
        <runscript />
        <locked type="boolean">false</locked>
        <script type="script">
          if (nursery5.door_closed) {
            msg ("A closed door blocks your way.")
          }
          else {
            MoveAndFace (nursery5, 1)
            Laila.paused = False
            if (game.debug) {
              msg ("DEBUG: unpause Laila")
            }
          }
        </script>
      </exit>
      <exit name="South48" alias="south" to="defaultroom">
        <inherit name="southdirection" />
        <runscript />
        <script type="script">
          MoveAndFace (nursery3, 2)
        </script>
      </exit>
      <exit name="West65" alias="west" to="defaultroom">
        <inherit name="westdirection" />
        <runscript />
        <visible />
        <script type="script">
          MoveAndFace (nursery7, 3)
        </script>
      </exit>
      <command name="Shut door3">
        <pattern type="string">(close|shut) door</pattern>
        <script>
          if (nursery5.door_closed) {
            msg ("The door is already closed.")
          }
          else {
            nursery5.door_closed = True
            msg ("You close the door.")
          }
        </script>
      </command>
      <command name="Open door3">
        <pattern type="string">(open|push|kick|hit|punch) door</pattern>
        <script>
          if (nursery5.door_closed) {
            msg ("The door swings open.")
            nursery5.door_closed = False
          }
          else {
            msg ("The door is already open.")
          }
        </script>
      </command>
    </object>
    <object name="nursery7">
      <inherit name="editor_room" />
      <usedefaultprefix />
      <descriptions type="stringdictionary">
        <item>
          <key>darknorth</key>
          <value>You cannot see anything.</value>
        </item>
        <item>
          <key>darkeast</key>
          <value>You cannot see anything.</value>
        </item>
        <item>
          <key>darksouth</key>
          <value>You cannot see anything. You can feel a piece of furniture in front if you.</value>
        </item>
        <item>
          <key>darkwest</key>
          <value>You cannot see anything.</value>
        </item>
        <item>
          <key>dimnorth</key>
          <value>There is a table to the southeast of you.</value>
        </item>
        <item>
          <key>dimeast</key>
          <value>There is a door a couple steps forwards, and a table to the southeast. </value>
        </item>
        <item>
          <key>dimsouth</key>
          <value>There is a dusty dresser in front of you. </value>
        </item>
        <item>
          <key>dimwest</key>
          <value>There is a dresser to the south of you.</value>
        </item>
        <item>
          <key>brightnorth</key>
          <value>There is a table to the southeast of you.</value>
        </item>
        <item>
          <key>brighteast</key>
          <value>There is a door a couple steps forwards, and a table to the southeast. </value>
        </item>
        <item>
          <key>brightsouth</key>
          <value>There is a dusty dresser in front of you.</value>
        </item>
        <item>
          <key>brightwest</key>
          <value>There is a dresser to the south of you.</value>
        </item>
      </descriptions>
      <description type="script"><![CDATA[
        PrintRoomDesc (False)
        if (nursery14.maven_here and lantern.light_level <> 0) {
          if (player.facing_num = 0) {
            msg ("You can see a glimmer hanging in the air to the northwest. It looks like the shape of a child.")
          }
          else if (player.facing_num = 3) {
            msg ("You can see a glimmer hanging in the air to the northwest. It looks like the shape of a child.")
          }
        }
      ]]></description>
      <exit name="North51" alias="north" to="defaultroom">
        <inherit name="northdirection" />
        <runscript />
        <script type="script">
          MoveAndFace (nursery13, 0)
        </script>
      </exit>
      <exit name="East70" alias="east" to="defaultroom">
        <inherit name="eastdirection" />
        <runscript />
        <script type="script">
          MoveAndFace (nursery6, 1)
        </script>
      </exit>
      <exit name="West66" alias="west" to="defaultroom">
        <inherit name="westdirection" />
        <runscript />
        <visible />
        <script type="script">
          MoveAndFace (nursery8, 3)
        </script>
      </exit>
    </object>
    <object name="nursery8">
      <inherit name="editor_room" />
      <usedefaultprefix />
      <descriptions type="stringdictionary">
        <item>
          <key>darknorth</key>
          <value>You cannot see anything.</value>
        </item>
        <item>
          <key>darkeast</key>
          <value>You cannot see anything. </value>
        </item>
        <item>
          <key>darksouth</key>
          <value>You cannot see anything. You can feel a dusty piece of furniture in front of you.</value>
        </item>
        <item>
          <key>darkwest</key>
          <value>You cannot see anything.</value>
        </item>
        <item>
          <key>dimnorth</key>
          <value>There is a small bed to the northwest of you.</value>
        </item>
        <item>
          <key>dimeast</key>
          <value>There is a small bed to the northwest of you.</value>
        </item>
        <item>
          <key>dimsouth</key>
          <value>There is a dusty dresser in front of you. </value>
        </item>
        <item>
          <key>dimwest</key>
          <value>There is a dresser to the south of you, and a small bed to the northwest. </value>
        </item>
        <item>
          <key>brightnorth</key>
          <value>There is a small bed to the northwest of you.</value>
        </item>
        <item>
          <key>brighteast</key>
          <value>There is a small bed to the northwest of you.</value>
        </item>
        <item>
          <key>brightsouth</key>
          <value>There is a dusty dresser in front of you.</value>
        </item>
        <item>
          <key>brightwest</key>
          <value>There is a dusty dresser to the south of you, and a small bed to the northwest.</value>
        </item>
      </descriptions>
      <description type="script"><![CDATA[
        PrintRoomDesc (False)
        if (nursery14.maven_here) {
          if (player.facing_num = 0) {
            if (lantern.light_level = 0) {
              msg ("There is a figure of a little boy in front of you, he is translucent.")
            }
            else {
              msg ("There is a figure of a little boy in front of you, he is translucent.")
            }
          }
          else if (player.facing_num = 1 and lantern.light_level <> 0) {
            msg ("There is a figure of a little boy to the north of you, he is translucent.")
          }
          else if (player.facing_num = 3 and lantern.light_level <> 0) {
            msg ("There is a figure of a little boy to the north of you, he is translucent.")
          }
        }
      ]]></description>
      <exit name="North53" alias="north" to="defaultroom">
        <inherit name="northdirection" />
        <runscript />
        <script type="script"><![CDATA[
          if (nursery14.maven_here) {
            if (player.facing_num <> 0) {
              msg ("You turn to move North and notice a ghost boy is already standing there.")
              FaceNorth
            }
            else {
              msg ("The ghost boy is there and walking through him feels... rude.")
            }
          }
          else {
            MoveAndFace (nursery14, 0)
          }
        ]]></script>
      </exit>
      <exit name="East71" alias="east" to="defaultroom">
        <inherit name="eastdirection" />
        <runscript />
        <script type="script">
          MoveAndFace (nursery7, 1)
        </script>
      </exit>
      <exit name="West70" alias="west" to="defaultroom">
        <inherit name="westdirection" />
        <runscript />
        <visible />
        <script type="script">
          MoveAndFace (nursery9, 3)
        </script>
      </exit>
      <command name="Talk to Maven1">
        <pattern type="string">(talk|talk to|talk to boy|talk to ghost|speak|speak to|speak to boy|speak to ghost)</pattern>
        <script>
          DisableHeart
          switch (Maven.conversation_part) {
            case (0) {
              msg ("'Another one, huh?' The little boy stares at you for a moment, he is small, frail looking, and in tattered clothing from a time long since past. 'Im Maven, will you play with me?'")
              Maven.conversation_part = 1
            }
            case (1) {
              msg ("'So will you play with me?' he asks again quietly.")
            }
          }
        </script>
      </command>
      <command name="Say Yes1">
        <pattern type="string">(say yes|yes|tell boy yes|tell ghost yes|accept|accept game|play|play with boy|play with ghost)</pattern>
        <script>
          if (Maven.conversation_part = 1) {
            DisableHeart
            Maven.conversation_part = 2
            msg ("'Oh, thank you! The others never want to play hide and seek is my favorite, I will hide, okay?' Maven turns and starts running away. He stops and turns back for a moment. 'You better come find me, but be careful of the others Laila, she wants to play too, but I dont think she knows what it means! She is really mean, I dont like to play with her. She doesn't like bright lights.'")
            nursery12.door_locked = false
            nursery31.door_locked = false
            nursery44.door_locked = false
            nursery46.door_locked = false
            nursery64.door_locked = false
            nursery14.maven_here = false
            nursery33.maven_here = True
            EnableTurnScript (laila_turn_script)
            msg ("He turns around and continues out of the room; you can hear him singing: 'Mary had a little lamb, His fleece was white as snow, And everywhere that Mary went, The lamb was sure to go.'")
            Maven.conversation_part = 2
          }
          else {
            msg ("I don't understand your command.")
          }
        </script>
      </command>
    </object>
    <object name="nursery9">
      <inherit name="editor_room" />
      <usedefaultprefix />
      <descriptions type="stringdictionary">
        <item>
          <key>darknorth</key>
          <value>You cannot see anything. You can feel a piece of furniture in front of you, covered with a blanket-like material.</value>
        </item>
        <item>
          <key>darkeast</key>
          <value>You cannot see anything.</value>
        </item>
        <item>
          <key>darksouth</key>
          <value>You cannot see anything.</value>
        </item>
        <item>
          <key>darkwest</key>
          <value>You cannot see anything. You can feel a wall in front of you.</value>
        </item>
        <item>
          <key>dimnorth</key>
          <value>There is a small bed in front of you. </value>
        </item>
        <item>
          <key>dimeast</key>
          <value>There is a small bed to the north of you.</value>
        </item>
        <item>
          <key>dimsouth</key>
          <value>There is a dresser to the southeast of you, and a wall to the west.</value>
        </item>
        <item>
          <key>dimwest</key>
          <value>There is a wall in front of you, and a small bed to the north.</value>
        </item>
        <item>
          <key>brightnorth</key>
          <value>There is a small bed in front of you.</value>
        </item>
        <item>
          <key>brighteast</key>
          <value>There is a small bed to the north of you, and a dresser to the southeast.</value>
        </item>
        <item>
          <key>brightsouth</key>
          <value>There is a dresser to the southeast of you, and a wall to the west. </value>
        </item>
        <item>
          <key>brightwest</key>
          <value>There is a wall in front of you, and a small bed to the north. </value>
        </item>
      </descriptions>
      <description type="script"><![CDATA[
        PrintRoomDesc (False)
        if (nursery14.maven_here and lantern.light_level <> 0) {
          if (player.facing_num = 0) {
            msg ("There is glimmer hanging in the air to the northeast. It has a child-like shape.")
          }
          else if (player.facing_num = 1) {
            msg ("There is glimmer hanging in the air to the northeast. It has a child-like shape.")
          }
        }
      ]]></description>
      <exit name="East72" alias="east" to="defaultroom">
        <inherit name="eastdirection" />
        <runscript />
        <script type="script">
          MoveAndFace (nursery8, 1)
        </script>
      </exit>
      <exit name="South54" alias="south" to="defaultroom">
        <inherit name="southdirection" />
        <runscript />
        <script type="script">
          MoveAndFace (nursery4, 2)
        </script>
      </exit>
    </object>
    <object name="nursery10">
      <inherit name="editor_room" />
      <usedefaultprefix />
      <descriptions type="stringdictionary">
        <item>
          <key>darknorth</key>
          <value>You cannot see anything. </value>
        </item>
        <item>
          <key>darkeast</key>
          <value>You cannot see anything. You can feel a wall in front of you.</value>
        </item>
        <item>
          <key>darksouth</key>
          <value>You cannot see anything. You can feel a wall in front of you.</value>
        </item>
        <item>
          <key>darkwest</key>
          <value>You cannot see anything.</value>
        </item>
        <item>
          <key>dimnorth</key>
          <value>There is a wall to the east of you. </value>
        </item>
        <item>
          <key>dimeast</key>
          <value>There is a wall in front of you, and to the south of you. </value>
        </item>
        <item>
          <key>dimsouth</key>
          <value>There is a wall in front of you, and to the east of you.</value>
        </item>
        <item>
          <key>dimwest</key>
          <value>There is a wall to the south of you.</value>
        </item>
        <item>
          <key>brightnorth</key>
          <value>There is a wall to the east of you, you are in a small closet.</value>
        </item>
        <item>
          <key>brighteast</key>
          <value>There is a wall in front of you, and to the south of you. You are in a small closet.</value>
        </item>
        <item>
          <key>brightsouth</key>
          <value>There is a wall in front of you, and to the east of you. You are in a small closet.</value>
        </item>
        <item>
          <key>brightwest</key>
          <value>There is a wall to the south of you, and a door a few steps forwards. You are in a small closet.</value>
        </item>
      </descriptions>
      <description type="script">
        PrintRoomDesc (False)
      </description>
      <exit name="North57" alias="north" to="defaultroom">
        <inherit name="northdirection" />
        <runscript />
        <script type="script">
          MoveAndFace (nursery15, 0)
        </script>
      </exit>
      <exit name="West46" alias="west" to="defaultroom">
        <inherit name="westdirection" />
        <runscript />
        <visible />
        <script type="script">
          MoveAndFace (nursery11, 3)
        </script>
      </exit>
    </object>
    <object name="nursery11">
      <inherit name="editor_room" />
      <usedefaultprefix />
      <descriptions type="stringdictionary">
        <item>
          <key>darknorth</key>
          <value>You cannot see anything. </value>
        </item>
        <item>
          <key>darkeast</key>
          <value>You cannot see anything.</value>
        </item>
        <item>
          <key>darksouth</key>
          <value>You cannot see anything. You can feel a wall in front of you.</value>
        </item>
        <item>
          <key>darkwest</key>
          <value>You cannot see anything. You can feel something in front of you.</value>
        </item>
        <item>
          <key>dimnorth</key>
          <value>There is a door to the west of you.</value>
        </item>
        <item>
          <key>dimeast</key>
          <value>There is a wall to the south of you.</value>
        </item>
        <item>
          <key>dimsouth</key>
          <value>There is a wall in front of you, and a door to the west.</value>
        </item>
        <item>
          <key>dimwest</key>
          <value>There is a door in front of you, and a wall to the south.</value>
        </item>
        <item>
          <key>brightnorth</key>
          <value>There is a door to the west of you. You are in a small closet.</value>
        </item>
        <item>
          <key>brighteast</key>
          <value>There is a wall to the south of you. You are in a small closet.</value>
        </item>
        <item>
          <key>brightsouth</key>
          <value>There is a wall in front of you, and a door to the west. You are in a small closet.</value>
        </item>
        <item>
          <key>brightwest</key>
          <value>There is a door in front of you, and a wall to the south. You are in a small closet.</value>
        </item>
      </descriptions>
      <description type="script">
        PrintRoomDesc (False)
      </description>
      <exit name="North59" alias="north" to="defaultroom">
        <inherit name="northdirection" />
        <runscript />
        <script type="script">
          MoveAndFace (nursery16, 0)
        </script>
      </exit>
      <exit name="East74" alias="east" to="defaultroom">
        <inherit name="eastdirection" />
        <runscript />
        <script type="script">
          MoveAndFace (nursery10, 1)
        </script>
      </exit>
      <exit name="West73" alias="west" to="defaultroom">
        <inherit name="westdirection" />
        <runscript />
        <visible />
        <script type="script">
          if (nursery12.door_closed) {
            msg ("A closed door blocks your way.")
          }
          else {
            MoveAndFace (nursery12, 3)
            Laila.paused = False
            if (game.debug) {
              msg ("DEBUG: unpause Laila")
            }
          }
        </script>
      </exit>
      <command name="Shut door4">
        <pattern type="string">(close|shut|lock) door</pattern>
        <script>
          if (nursery12.door_closed) {
            msg ("The door is already closed.")
          }
          else {
            nursery12.door_closed = True
            msg ("You close the door.")
          }
        </script>
      </command>
      <command name="Open door4">
        <pattern type="string">(open|push|kick|hit|punch) door</pattern>
        <script>
          if (nursery12.door_closed) {
            msg ("The door swings open.")
            nursery12.door_closed = False
          }
          else {
            msg ("The door is already open.")
          }
        </script>
      </command>
    </object>
    <object name="nursery12">
      <inherit name="editor_room" />
      <usedefaultprefix />
      <descriptions type="stringdictionary">
        <item>
          <key>darknorth</key>
          <value>You cannot see anything.</value>
        </item>
        <item>
          <key>darkeast</key>
          <value>You cannot see anything. You can feel something in front of you.</value>
        </item>
        <item>
          <key>darksouth</key>
          <value>You cannot see anything.</value>
        </item>
        <item>
          <key>darkwest</key>
          <value>You cannot see anything. You can feel a wall in front of you.</value>
        </item>
        <item>
          <key>dimnorth</key>
          <value>You are in a narrow hallway, there is a door to the east, and a wall to the west of you. There is a painting of a lady on the wall. </value>
        </item>
        <item>
          <key>dimeast</key>
          <value>You are in a narrow hallway, there is a door in front of you.</value>
        </item>
        <item>
          <key>dimsouth</key>
          <value>There is a door to the east of you, and a wall to the west. There is a painting of a lady on the wall.</value>
        </item>
        <item>
          <key>dimwest</key>
          <value>You are in a narrow hallway, there is a wall in front of you. There is a painting of a lady on the wall.</value>
        </item>
        <item>
          <key>brightnorth</key>
          <value>You are in a narrow hallway, there is a door to the east, and a wall to the west of you. On the wall there is a painting of a lady. It feels like she is watching you.</value>
        </item>
        <item>
          <key>brighteast</key>
          <value>You are in a narrow hallway, there is a door in front of you.</value>
        </item>
        <item>
          <key>brightsouth</key>
          <value>There is a door to the east of you, and a wall to the west. There is a painting of a lady on the wall. It feels like she is watching you.</value>
        </item>
        <item>
          <key>brightwest</key>
          <value>You are in a narrow hallway, there is a wall in front of you. There is a painting of a lady on the wall, it feels like she is watching you. </value>
        </item>
      </descriptions>
      <door_closed />
      <door_locked />
      <description type="script">
        PrintRoomDesc (False)
      </description>
      <exit name="North60" alias="north" to="defaultroom">
        <inherit name="northdirection" />
        <runscript />
        <script type="script">
          MoveAndFace (nursery17, 0)
        </script>
      </exit>
      <exit name="East76" alias="east" to="defaultroom">
        <inherit name="eastdirection" />
        <runscript />
        <script type="script">
          if (nursery12.door_closed) {
            msg ("A closed door blocks your way.")
          }
          else {
            MoveAndFace (nursery11, 1)
            Laila.paused = True
            if (game.debug) {
              msg ("DEBUG: pause Laila")
            }
          }
        </script>
      </exit>
      <exit name="South59" alias="south" to="defaultroom">
        <inherit name="southdirection" />
        <runscript />
        <script type="script">
          MoveAndFace (nursery5, 2)
        </script>
      </exit>
      <command name="Shut door5">
        <pattern type="string">(close|shut|lock) door</pattern>
        <script>
          if (nursery12.door_closed) {
            msg ("The door is already closed.")
          }
          else {
            nursery12.door_closed = True
            msg ("You close the door.")
          }
        </script>
      </command>
      <command name="Open door5">
        <pattern type="string">(open|push|kick|hit|punch) door</pattern>
        <script>
          if (nursery12.door_locked) {
            msg ("You turn the handle but find the door locked.")
          }
          else {
            if (nursery12.door_closed) {
              msg ("The door swings open.")
              nursery12.door_closed = False
            }
            else {
              msg ("The door is already open.")
            }
          }
        </script>
      </command>
    </object>
    <object name="nursery13">
      <inherit name="editor_room" />
      <usedefaultprefix />
      <descriptions type="stringdictionary">
        <item>
          <key>darknorth</key>
          <value>You cannot see anything.</value>
        </item>
        <item>
          <key>darkeast</key>
          <value>You cannot see anything. You can feel a hard surface in front of you.</value>
        </item>
        <item>
          <key>darksouth</key>
          <value>You cannot see anything. </value>
        </item>
        <item>
          <key>darkwest</key>
          <value>You cannot see anything.</value>
        </item>
        <item>
          <key>dimnorth</key>
          <value>There is a table to the east of you.</value>
        </item>
        <item>
          <key>dimeast</key>
          <value>There is a table in front of you.</value>
        </item>
        <item>
          <key>dimsouth</key>
          <value>There is a table to the east of you.</value>
        </item>
        <item>
          <key>dimwest</key>
          <value> There is a small bed a few steps forwards.</value>
        </item>
        <item>
          <key>brightnorth</key>
          <value>There is a table to the east of you, and a wall a few steps forwards.</value>
        </item>
        <item>
          <key>brighteast</key>
          <value>There is a table in front of you, and a door to the southeast. </value>
        </item>
        <item>
          <key>brightsouth</key>
          <value>There is a table to the east of you, and a dresser a few steps forwards.</value>
        </item>
        <item>
          <key>brightwest</key>
          <value>There is a small bed a few steps forwards, and a wall a few steps north.</value>
        </item>
      </descriptions>
      <description type="script"><![CDATA[
        PrintRoomDesc (False)
        if (nursery14.maven_here) {
          if (player.facing_num = 3) {
            if (lantern.light_level = 0) {
              msg ("There is a figure of a small boy hanging in the air in front of you. He is looking up at you.")
            }
            else {
              msg ("There is a figure of a small boy hanging in the air in front of the bed. He is looking up at you.")
            }
          }
          else if (player.facing_num = 2 and lantern.light_level <> 0) {
            msg ("There is a figure of a small boy hanging in the air to the west of you.")
          }
          else if (player.facing_num = 0 and lantern.light_level <> 0) {
            msg ("There is a figure of a small boy hanging in the air to the west of you.")
          }
        }
      ]]></description>
      <exit name="North67" alias="north" to="defaultroom">
        <inherit name="northdirection" />
        <runscript />
        <script type="script">
          MoveAndFace (nursery18, 0)
        </script>
      </exit>
      <exit name="South66" alias="south" to="defaultroom">
        <inherit name="southdirection" />
        <runscript />
        <script type="script">
          MoveAndFace (nursery7, 2)
        </script>
      </exit>
      <exit name="West76" alias="west" to="defaultroom">
        <inherit name="westdirection" />
        <runscript />
        <visible />
        <script type="script"><![CDATA[
          if (nursery14.maven_here) {
            if (player.facing_num <> 3) {
              msg ("You turn to move West and notice a ghost boy is already standing there.")
              FaceWest
            }
            else {
              msg ("The ghost boy is there and walking through him feels... rude.")
            }
          }
          else {
            MoveAndFace (nursery14, 3)
          }
        ]]></script>
      </exit>
      <command name="Talk to Maven">
        <pattern type="string">(talk|talk to|talk to boy|talk to ghost|speak|speak to|speak to boy|speak to ghost)</pattern>
        <script>
          DisableHeart
          switch (Maven.conversation_part) {
            case (0) {
              msg ("'Another one, huh?' The little boy stares at you for a moment, he is small, frail looking, and in tattered clothing from a time long since past. 'Im Maven, will you play with me?'")
              Maven.conversation_part = 1
            }
            case (1) {
              msg ("'So will you play with me?' he asks again quietly.")
            }
          }
        </script>
      </command>
      <command name="Say Yes">
        <pattern type="string">(say yes|yes|tell boy yes|tell ghost yes|accept|accept game|play|play with boy|play with ghost)</pattern>
        <script>
          if (Maven.conversation_part = 1) {
            DisableHeart
            Maven.conversation_part = 2
            msg ("\"Oh, thank you! The others never want to play hide and seek is my favorite, I will hide, okay?\" Maven turns and starts running away. He stops and turns back for a moment. \"You better come find me, but be careful of the others Laila, she wants to play too, but I dont think she knows what it means! She is really mean, I dont like to play with her. She doesn't like bright lights.\"")
            nursery12.door_locked = false
            nursery31.door_locked = false
            nursery44.door_locked = false
            nursery46.door_locked = false
            nursery64.door_locked = false
            nursery14.maven_here = false
            EnableTurnScript (laila_turn_script)
            nursery33.maven_here = True
            msg ("He turns around and continues out of the room; you can hear him singing: 'Mary had a little lamb, His fleece was white as snow, And everywhere that Mary went, The lamb was sure to go.'")
            Maven.conversation_part = 2
          }
          else {
            msg ("I don't understand your command.")
          }
        </script>
      </command>
    </object>
    <object name="nursery14">
      <inherit name="editor_room" />
      <usedefaultprefix />
      <descriptions type="stringdictionary">
        <item>
          <key>darknorth</key>
          <value>You cannot see anything.</value>
        </item>
        <item>
          <key>darkeast</key>
          <value>You cannot see anything.</value>
        </item>
        <item>
          <key>darksouth</key>
          <value>You cannot see anything.</value>
        </item>
        <item>
          <key>darkwest</key>
          <value>You cannot see anything. You can feel some kind of blanket-covered piece of furniture in front of you.</value>
        </item>
        <item>
          <key>dimnorth</key>
          <value>There is a small bed to the west of you.</value>
        </item>
        <item>
          <key>dimeast</key>
          <value>There is a table a few steps forwards.</value>
        </item>
        <item>
          <key>dimsouth</key>
          <value>There is a small bed to the west of you.</value>
        </item>
        <item>
          <key>dimwest</key>
          <value>There is a small bed in front of you.</value>
        </item>
        <item>
          <key>brightnorth</key>
          <value>There is a small bed to the west of you, and a wall a few steps forwards. </value>
        </item>
        <item>
          <key>brighteast</key>
          <value>There is a small table a few steps forwards, and a wall to the north. </value>
        </item>
        <item>
          <key>brightsouth</key>
          <value>There is a small bed to the west of you, and a dresser a few steps south.</value>
        </item>
        <item>
          <key>brightwest</key>
          <value>There is a small bed in front of you, and a wall to the north. </value>
        </item>
      </descriptions>
      <maven_here />
      <description type="script">
        PrintRoomDesc (False)
      </description>
      <exit name="North68" alias="north" to="defaultroom">
        <inherit name="northdirection" />
        <runscript />
        <script type="script">
          MoveAndFace (nursery19, 0)
        </script>
      </exit>
      <exit name="East78" alias="east" to="defaultroom">
        <inherit name="eastdirection" />
        <runscript />
        <script type="script">
          MoveAndFace (nursery13, 1)
        </script>
      </exit>
      <exit name="South67" alias="south" to="defaultroom">
        <inherit name="southdirection" />
        <runscript />
        <script type="script">
          MoveAndFace (nursery8, 2)
        </script>
      </exit>
    </object>
    <object name="nursery15">
      <inherit name="editor_room" />
      <usedefaultprefix />
      <descriptions type="stringdictionary">
        <item>
          <key>darknorth</key>
          <value>You cannot see anything. You can feel a wall in front of you.</value>
        </item>
        <item>
          <key>darkeast</key>
          <value>You cannot see anything. You can feel a wall in front of you.</value>
        </item>
        <item>
          <key>darksouth</key>
          <value>You cannot see anything.</value>
        </item>
        <item>
          <key>darkwest</key>
          <value>You cannot see anything. </value>
        </item>
        <item>
          <key>dimnorth</key>
          <value>There is a wall in front of you, and to the east of you.</value>
        </item>
        <item>
          <key>dimeast</key>
          <value>There is a wall in front of you, and to the north of you.</value>
        </item>
        <item>
          <key>dimsouth</key>
          <value>There is a wall to the east of you.</value>
        </item>
        <item>
          <key>dimwest</key>
          <value>There is a wall to the north of you.</value>
        </item>
        <item>
          <key>brightnorth</key>
          <value>There is a wall in front of you, and to the east of you. You are in a small closet.</value>
        </item>
        <item>
          <key>brighteast</key>
          <value>There is a wall in front of you, and to the north of you. You are in a small closet.</value>
        </item>
        <item>
          <key>brightsouth</key>
          <value>There is a wall to the east of you. You are in a small closet.</value>
        </item>
        <item>
          <key>brightwest</key>
          <value>There is a wall to the north of you. You are in a small closet. </value>
        </item>
      </descriptions>
      <description type="script">
        PrintRoomDesc (False)
      </description>
      <exit name="South68" alias="south" to="defaultroom">
        <inherit name="southdirection" />
        <runscript />
        <script type="script">
          MoveAndFace (nursery10, 2)
        </script>
      </exit>
      <exit name="West78" alias="west" to="defaultroom">
        <inherit name="westdirection" />
        <runscript />
        <visible />
        <script type="script">
          MoveAndFace (nursery16, 3)
        </script>
      </exit>
    </object>
    <object name="nursery16">
      <inherit name="editor_room" />
      <usedefaultprefix />
      <descriptions type="stringdictionary">
        <item>
          <key>darknorth</key>
          <value>You cannot see anything. You can feel a wall in front of you.</value>
        </item>
        <item>
          <key>darkeast</key>
          <value>You cannot see anything.</value>
        </item>
        <item>
          <key>darksouth</key>
          <value>You cannot see anything.</value>
        </item>
        <item>
          <key>darkwest</key>
          <value>You cannot see anything. You can feel a wall in front of you.</value>
        </item>
        <item>
          <key>dimnorth</key>
          <value>There is a wall in front of you, and to the west of you.</value>
        </item>
        <item>
          <key>dimeast</key>
          <value>There is a wall to the north of you.</value>
        </item>
        <item>
          <key>dimsouth</key>
          <value>There is a wall to the west of you.</value>
        </item>
        <item>
          <key>dimwest</key>
          <value>There is a wall in front of you, and to the north of you.</value>
        </item>
        <item>
          <key>brightnorth</key>
          <value>There is a wall in front of you, and to the west of you. You are in a small closet.</value>
        </item>
        <item>
          <key>brighteast</key>
          <value>There is a wall to the north of you. You are in a small closet. </value>
        </item>
        <item>
          <key>brightsouth</key>
          <value>There is a wall to the west of you. You are in a small closet. </value>
        </item>
        <item>
          <key>brightwest</key>
          <value>There is a wall in front of you, and to the north of you. You are in a small closet. </value>
        </item>
      </descriptions>
      <description type="script">
        PrintRoomDesc (False)
      </description>
      <exit name="East83" alias="east" to="defaultroom">
        <inherit name="eastdirection" />
        <runscript />
        <script type="script">
          MoveAndFace (nursery15, 1)
        </script>
      </exit>
      <exit name="South78" alias="south" to="defaultroom">
        <inherit name="southdirection" />
        <runscript />
        <script type="script">
          MoveAndFace (nursery11, 2)
        </script>
      </exit>
    </object>
    <object name="nursery17">
      <inherit name="editor_room" />
      <usedefaultprefix />
      <descriptions type="stringdictionary">
        <item>
          <key>darknorth</key>
          <value>You cannot see anything.</value>
        </item>
        <item>
          <key>darkeast</key>
          <value>You cannot see anything. You can feel a wall in front of you.</value>
        </item>
        <item>
          <key>darksouth</key>
          <value>You cannot see anything.</value>
        </item>
        <item>
          <key>darkwest</key>
          <value>You cannot see anything. You can feel a wall in front of you.</value>
        </item>
        <item>
          <key>dimnorth</key>
          <value>You are in a narrow hallway, there is a wall to the east, and to the west of you.</value>
        </item>
        <item>
          <key>dimeast</key>
          <value>You are in a narrow hallway, there is a wall in front of you.</value>
        </item>
        <item>
          <key>dimsouth</key>
          <value>You are in a narrow hallway, there is a wall to the east, and to the west of you.</value>
        </item>
        <item>
          <key>dimwest</key>
          <value>You are in a narrow hallway, there is a wall in front of you.</value>
        </item>
        <item>
          <key>brightnorth</key>
          <value>You are in a narrow hallway, there is a wall to the east, and to the west of you.</value>
        </item>
        <item>
          <key>brighteast</key>
          <value>You are in a narrow hallway, there is a wall in front of you.</value>
        </item>
        <item>
          <key>brightsouth</key>
          <value>You are in a narrow hallway, there is a wall to the east, and to the west of you.</value>
        </item>
        <item>
          <key>brightwest</key>
          <value>You are in a narrow hallway, there is a wall in front of you.</value>
        </item>
      </descriptions>
      <description type="script">
        PrintRoomDesc (False)
      </description>
      <exit name="North80" alias="north" to="defaultroom">
        <inherit name="northdirection" />
        <runscript />
        <script type="script">
          MoveAndFace (nursery20, 0)
        </script>
      </exit>
      <exit name="South79" alias="south" to="defaultroom">
        <inherit name="southdirection" />
        <runscript />
        <script type="script">
          MoveAndFace (nursery12, 2)
        </script>
      </exit>
    </object>
    <object name="nursery18">
      <inherit name="editor_room" />
      <usedefaultprefix />
      <descriptions type="stringdictionary">
        <item>
          <key>darknorth</key>
          <value>You cannot see anything. You can feel a wall in front of you.</value>
        </item>
        <item>
          <key>darkeast</key>
          <value>You cannot see anything. You can feel a hard surface in front of you.</value>
        </item>
        <item>
          <key>darksouth</key>
          <value>You cannot see anything.</value>
        </item>
        <item>
          <key>darkwest</key>
          <value>You cannot see anything.</value>
        </item>
        <item>
          <key>dimnorth</key>
          <value>There is a wall in front of you, and a table to the east.</value>
        </item>
        <item>
          <key>dimeast</key>
          <value>There is a table in front of you, and a wall to the north.</value>
        </item>
        <item>
          <key>dimsouth</key>
          <value>There is a table to the east of you.</value>
        </item>
        <item>
          <key>dimwest</key>
          <value>There is a wall to the north of you.</value>
        </item>
        <item>
          <key>brightnorth</key>
          <value>There is a wall in front of you, and a table to the east. There is a small bed a few steps west.</value>
        </item>
        <item>
          <key>brighteast</key>
          <value>There is a table in front of you, and a wall to the north.</value>
        </item>
        <item>
          <key>brightsouth</key>
          <value>There is a table to the east of you. There is a small bed a few steps to the west.</value>
        </item>
        <item>
          <key>brightwest</key>
          <value>There is a wall to the north of you. There is a small bed a few steps forwards.</value>
        </item>
      </descriptions>
      <description type="script"><![CDATA[
        PrintRoomDesc (False)
        if (nursery14.maven_here and lantern.light_level <> 0) {
          if (player.facing_num = 2) {
            msg ("There is a figure of a small boy hanging in the air to the southwest, he is translucent.")
          }
          else if (player.facing_num = 3) {
            msg ("There is a figure of a small boy hanging in the air to the southwest, he is translucent.")
          }
        }
      ]]></description>
      <exit name="South80" alias="south" to="defaultroom">
        <inherit name="southdirection" />
        <runscript />
        <script type="script">
          MoveAndFace (nursery13, 2)
        </script>
      </exit>
      <exit name="West84" alias="west" to="defaultroom">
        <inherit name="westdirection" />
        <runscript />
        <visible />
        <script type="script">
          MoveAndFace (nursery19, 3)
        </script>
      </exit>
    </object>
    <object name="nursery19">
      <inherit name="editor_room" />
      <usedefaultprefix />
      <descriptions type="stringdictionary">
        <item>
          <key>darknorth</key>
          <value>You cannot see anything. You can feel a wall in front of you.</value>
        </item>
        <item>
          <key>darkeast</key>
          <value>You cannot see anything.  </value>
        </item>
        <item>
          <key>darksouth</key>
          <value>You cannot see anything.</value>
        </item>
        <item>
          <key>darkwest</key>
          <value>You cannot see anything. You can feel a piece of furniture in front of you. </value>
        </item>
        <item>
          <key>dimnorth</key>
          <value>There is a wall in front of you, and a small bed to the west.</value>
        </item>
        <item>
          <key>dimeast</key>
          <value>There is a wall to the north of you.</value>
        </item>
        <item>
          <key>dimsouth</key>
          <value>There is a small bed to the west of you.</value>
        </item>
        <item>
          <key>dimwest</key>
          <value>There is a small bed in front of you, and a wall to the north.</value>
        </item>
        <item>
          <key>brightnorth</key>
          <value>There is a wall in front of you, and a small bed to the west.</value>
        </item>
        <item>
          <key>brighteast</key>
          <value>There is a wall to the north of you, and a small table a few steps forwards.</value>
        </item>
        <item>
          <key>brightsouth</key>
          <value>There is a small bed to the west of you.</value>
        </item>
        <item>
          <key>brightwest</key>
          <value>There is a small bed in front of you, and a wall to the north.</value>
        </item>
      </descriptions>
      <description type="script"><![CDATA[
        PrintRoomDesc (False)
        if (nursery14.maven_here) {
          if (player.facing_num = 2) {
            if (lantern.light_level = 0) {
              msg ("There is a translucent figure of a small boy hanging in the air in front of you.")
            }
            else {
              msg ("There is a translucent figure of a small boy hanging in the air in front of you.")
            }
          }
          else if (player.facing_num = 1 and lantern.light_level <> 0) {
            msg ("There is a translucent figure of a small boy hanging in the air to the south of you.")
          }
          else if (player.facing_num = 3 and lantern.light_level <> 0) {
            msg ("There is a translucent figure of a small boy hanging in the air to the south of you.")
          }
        }
      ]]></description>
      <exit name="East86" alias="east" to="defaultroom">
        <inherit name="eastdirection" />
        <runscript />
        <script type="script">
          MoveAndFace (nursery18, 1)
        </script>
      </exit>
      <exit name="South87" alias="south" to="defaultroom">
        <inherit name="southdirection" />
        <runscript />
        <script type="script"><![CDATA[
          if (nursery14.maven_here) {
            if (player.facing_num <> 2) {
              msg ("You turn to move South and notice a ghost boy is already standing there.")
              FaceSouth
            }
            else {
              msg ("The ghost boy is there and walking through him feels... rude.")
            }
          }
          else {
            MoveAndFace (nursery14, 2)
          }
        ]]></script>
      </exit>
      <command name="Talk to Maven2">
        <pattern type="string">(talk|talk to|talk to boy|talk to ghost|speak|speak to|speak to boy|speak to ghost)</pattern>
        <script>
          DisableHeart
          switch (Maven.conversation_part) {
            case (0) {
              msg ("'Another one, huh?' The little boy stares at you for a moment, he is small, frail looking, and in tattered clothing from a time long since past. 'Im Maven, will you play with me?'")
              Maven.conversation_part = 1
            }
            case (1) {
              msg ("'So will you play with me?' he asks again quietly.")
            }
          }
        </script>
      </command>
      <command name="Say Yes2">
        <pattern type="string">(say yes|yes|tell boy yes|tell ghost yes|accept|accept game|play|play with boy|play with ghost)</pattern>
        <script>
          if (Maven.conversation_part = 1) {
            DisableHeart
            Maven.conversation_part = 2
            msg ("\"Oh, thank you! The others never want to play hide and seek is my favorite, I will hide, okay?\" Maven turns and starts running away. He stops and turns back for a moment. \"You better come find me, but be careful of the others Laila, she wants to play too, but I dont think she knows what it means! She is really mean, I dont like to play with her. She doesn't like bright lights.\"")
            nursery12.door_locked = false
            nursery31.door_locked = false
            nursery44.door_locked = false
            nursery46.door_locked = false
            nursery64.door_locked = false
            nursery14.maven_here = false
            EnableTurnScript (laila_turn_script)
            nursery33.maven_here = True
            msg ("He turns around and continues out of the room; you can hear him singing: 'Mary had a little lamb, His fleece was white as snow, And everywhere that Mary went, The lamb was sure to go.'")
            Maven.conversation_part = 2
          }
          else {
            msg ("I don't understand your command.")
            EnableTurnScript (laila_turn_script)
            msg ("He turns around and continues out of the room; you can hear him singing: 'Mary had a little lamb, His fleece was white as snow, And everywhere that Mary went, The lamb was sure to go.'")
          }
        </script>
      </command>
    </object>
    <object name="nursery20">
      <inherit name="editor_room" />
      <usedefaultprefix />
      <descriptions type="stringdictionary">
        <item>
          <key>darknorth</key>
          <value>You cannot see anything.</value>
        </item>
        <item>
          <key>darkeast</key>
          <value>You cannot see anything. You can feel a wall in front of you.</value>
        </item>
        <item>
          <key>darksouth</key>
          <value>You cannot see anything.</value>
        </item>
        <item>
          <key>darkwest</key>
          <value>You cannot see anything. You can feel a wall in front of you.</value>
        </item>
        <item>
          <key>dimnorth</key>
          <value>You are in a narrow hallway, there is a wall to the east, and to the west of you.</value>
        </item>
        <item>
          <key>dimeast</key>
          <value>You are in a narrow hallway, there is a wall in front of you.</value>
        </item>
        <item>
          <key>dimsouth</key>
          <value>You are in a narrow hallway, there is a wall to the east, and to the west of you.</value>
        </item>
        <item>
          <key>dimwest</key>
          <value>You are in a narrow hallway, there is a wall in front of you.</value>
        </item>
        <item>
          <key>brightnorth</key>
          <value>You are in a narrow hallway, there is a wall to the east, and to the west of you.</value>
        </item>
        <item>
          <key>brighteast</key>
          <value>You are in a narrow hallway, there is a wall in front of you.</value>
        </item>
        <item>
          <key>brightsouth</key>
          <value>You are in a narrow hallway, there is a wall to the east, and to the west of you.</value>
        </item>
        <item>
          <key>brightwest</key>
          <value>You are in a narrow hallway, there is a wall in front of you.</value>
        </item>
      </descriptions>
      <description type="script">
        PrintRoomDesc (False)
      </description>
      <exit name="North89" alias="north" to="defaultroom">
        <inherit name="northdirection" />
        <runscript />
        <script type="script">
          MoveAndFace (nursery23, 0)
        </script>
      </exit>
      <exit name="South88" alias="south" to="defaultroom">
        <inherit name="southdirection" />
        <runscript />
        <script type="script">
          MoveAndFace (nursery17, 2)
        </script>
      </exit>
    </object>
    <object name="nursery21">
      <inherit name="editor_room" />
      <usedefaultprefix />
      <descriptions type="stringdictionary">
        <item>
          <key>darknorth</key>
          <value>You cannot see anything.</value>
        </item>
        <item>
          <key>darkeast</key>
          <value>You cannot see anything. You can feel a wall in front of you.</value>
        </item>
        <item>
          <key>darksouth</key>
          <value>You cannot see anything. You can feel a wall in front of you.</value>
        </item>
        <item>
          <key>darkwest</key>
          <value>You cannot see anything.</value>
        </item>
        <item>
          <key>dimnorth</key>
          <value>There is a wall to the east of you.</value>
        </item>
        <item>
          <key>dimeast</key>
          <value>There is a wall in front of you, and to the south of you. </value>
        </item>
        <item>
          <key>dimsouth</key>
          <value>There is a wall in front of you, and to the east of you. </value>
        </item>
        <item>
          <key>dimwest</key>
          <value>There is a wall to the south of you.</value>
        </item>
        <item>
          <key>brightnorth</key>
          <value>There is a wall to the east of you. There is a door a step forwards, and to the east. </value>
        </item>
        <item>
          <key>brighteast</key>
          <value>There is a wall in front of you, and to the south of you. You are in a corner of the room.</value>
        </item>
        <item>
          <key>brightsouth</key>
          <value>There is a wall in front of you, and to the east of you. You are in a corner of the room.</value>
        </item>
        <item>
          <key>brightwest</key>
          <value>There is a wall to the south of you. There is what appears to be a childrens toy chest a few steps forwards.</value>
        </item>
      </descriptions>
      <description type="script">
        PrintRoomDesc (False)
      </description>
      <exit name="North90" alias="north" to="defaultroom">
        <inherit name="northdirection" />
        <runscript />
        <script type="script">
          MoveAndFace (nursery27, 0)
        </script>
      </exit>
      <exit name="West90" alias="west" to="defaultroom">
        <inherit name="westdirection" />
        <runscript />
        <visible />
        <script type="script">
          MoveAndFace (nursery22, 3)
        </script>
      </exit>
    </object>
    <object name="nursery22">
      <inherit name="editor_room" />
      <usedefaultprefix />
      <descriptions type="stringdictionary">
        <item>
          <key>darknorth</key>
          <value>You cannot see anything.</value>
        </item>
        <item>
          <key>darkeast</key>
          <value>You cannot see anything.</value>
        </item>
        <item>
          <key>darksouth</key>
          <value>You cannot see anything. You can feel a wall in front of you.</value>
        </item>
        <item>
          <key>darkwest</key>
          <value>You cannot see anything. You can feel something in front of you. It is covered in cobwebs, and as you brush it off it feels like spiders are running up your arms.</value>
        </item>
        <item>
          <key>dimnorth</key>
          <value>There is a childrens toychest to the west of you. It is covered in cobwebs, and crawling with spiders.</value>
        </item>
        <item>
          <key>dimeast</key>
          <value>There is a wall to the south of you. </value>
        </item>
        <item>
          <key>dimsouth</key>
          <value>There is a wall in front of you, and a childrens toy chest to the west. It is infested with spiders.</value>
        </item>
        <item>
          <key>dimwest</key>
          <value>There is a childrens toy chest in front of you, and a wall to the south of you. The toy chest is covered in cobwebs, and spiders are running across it. </value>
        </item>
        <item>
          <key>brightnorth</key>
          <value>There is a childrens toy chest to the west of you. It is covered in cobwebs, and crawling with spiders. </value>
        </item>
        <item>
          <key>brighteast</key>
          <value>There is a wall to the south of you. </value>
        </item>
        <item>
          <key>brightsouth</key>
          <value>There is a wall in front of you, and a childrens toy chest to the west. It is infested with spiders, and covered in cobwebs.</value>
        </item>
        <item>
          <key>brightwest</key>
          <value>There is a childrens toy chest in front of you, and a wall to the south of you. The toy chest is covered in cobwebs, and spiders are running across it. </value>
        </item>
      </descriptions>
      <description type="script">
        PrintRoomDesc (False)
      </description>
      <exit name="North97" alias="north" to="defaultroom">
        <inherit name="northdirection" />
        <runscript />
        <script type="script">
          MoveAndFace (nursery28, 0)
        </script>
      </exit>
      <exit name="East93" alias="east" to="defaultroom">
        <inherit name="eastdirection" />
        <runscript />
        <script type="script">
          MoveAndFace (nursery21, 1)
        </script>
      </exit>
    </object>
    <object name="nursery23">
      <inherit name="editor_room" />
      <usedefaultprefix />
      <descriptions type="stringdictionary">
        <item>
          <key>darknorth</key>
          <value>You cannot see anything.</value>
        </item>
        <item>
          <key>darkeast</key>
          <value>You cannot see anything. You can feel a wall in front of you.</value>
        </item>
        <item>
          <key>darksouth</key>
          <value>You cannot see anything.</value>
        </item>
        <item>
          <key>darkwest</key>
          <value>You cannot see anything. You can feel a wall in front of you.</value>
        </item>
        <item>
          <key>dimnorth</key>
          <value>You are in a narrow hallway, there is a wall to the east, and to the west of you.</value>
        </item>
        <item>
          <key>dimeast</key>
          <value>You are in a narrow hallway, there is a wall in front of you. </value>
        </item>
        <item>
          <key>dimsouth</key>
          <value>You are in a narrow hallway, there is a wall to the east, and to the west of you.</value>
        </item>
        <item>
          <key>dimwest</key>
          <value>You are in a narrow hallway, there is a wall in front of you.</value>
        </item>
        <item>
          <key>brightnorth</key>
          <value>You are in a narrow hallway, there is a wall to the east, and to the west of you.</value>
        </item>
        <item>
          <key>brighteast</key>
          <value>You are in a narrow hallway, there is a wall in front of you.</value>
        </item>
        <item>
          <key>brightsouth</key>
          <value>You are in a narrow hallway, there is a wall to the east, and to the west of you.</value>
        </item>
        <item>
          <key>brightwest</key>
          <value>You are in a narrow hallway, there is a wall in front of you.</value>
        </item>
      </descriptions>
      <description type="script">
        PrintRoomDesc (False)
      </description>
      <exit name="North100" alias="north" to="defaultroom">
        <inherit name="northdirection" />
        <runscript />
        <script type="script">
          MoveAndFace (nursery31, 0)
        </script>
      </exit>
      <exit name="South99" alias="south" to="defaultroom">
        <inherit name="southdirection" />
        <runscript />
        <script type="script">
          MoveAndFace (nursery20, 2)
        </script>
      </exit>
    </object>
    <object name="nursery24">
      <inherit name="editor_room" />
      <usedefaultprefix />
      <descriptions type="stringdictionary">
        <item>
          <key>darknorth</key>
          <value>You cannot see anything.</value>
        </item>
        <item>
          <key>darkeast</key>
          <value>You cannot see anything. You can feel a wall in front of you.</value>
        </item>
        <item>
          <key>darksouth</key>
          <value>You cannot see anything. You can feel a wall in front of you.</value>
        </item>
        <item>
          <key>darkwest</key>
          <value>You cannot see anything. There is a pile of soft objects in front of you, resting on what feels like a table.</value>
        </item>
        <item>
          <key>dimnorth</key>
          <value>There is a pile of toys rest on a small table to the west of you, and a wall to the east.</value>
        </item>
        <item>
          <key>dimeast</key>
          <value>There is a wall in front of you, and to the south of you.</value>
        </item>
        <item>
          <key>dimsouth</key>
          <value>There is a wall in front of you, and to the east of you. To the west is a pile of toys resting on a small table. </value>
        </item>
        <item>
          <key>dimwest</key>
          <value>You are in a small room. There is a pile of toys resting on a small table in front of you. There are some teddy bears missing buttons, limbs, and stuffing strewn about. </value>
        </item>
        <item>
          <key>brightnorth</key>
          <value>There is a pile of toys rest on a small table to the west of you, and a wall to the east. You are in a small room.</value>
        </item>
        <item>
          <key>brighteast</key>
          <value>There is a wall in front of you, and to the south of you. You are in the corner of a small room.</value>
        </item>
        <item>
          <key>brightsouth</key>
          <value>There is a wall in front of you, and to the east of you. To the west is a pile of toys resting on a small table. You are in the corner of a small room.</value>
        </item>
        <item>
          <key>brightwest</key>
          <value>You are in a small room. There is a pile of toys resting on a small table in front of you. There are some teddy bears missing buttons, limbs, and stuffing strewn about. You are in the corner of a small room. </value>
        </item>
      </descriptions>
      <description type="script">
        PrintRoomDesc (False)
      </description>
      <exit name="North101" alias="north" to="defaultroom">
        <inherit name="northdirection" />
        <runscript />
        <script type="script">
          MoveAndFace (nursery32, 0)
        </script>
      </exit>
    </object>
    <object name="nursery25">
      <inherit name="editor_room" />
      <usedefaultprefix />
      <descriptions type="stringdictionary">
        <item>
          <key>darknorth</key>
          <value>You cannot see anything.</value>
        </item>
        <item>
          <key>darkeast</key>
          <value>You cannot see anything. You feel something in front of you.</value>
        </item>
        <item>
          <key>darksouth</key>
          <value>You cannot see anything. You can feel a hard surface in front of you.</value>
        </item>
        <item>
          <key>darkwest</key>
          <value>You cannot see anything.</value>
        </item>
        <item>
          <key>dimnorth</key>
          <value>There is a small crib to the east of you.</value>
        </item>
        <item>
          <key>dimeast</key>
          <value>There is a small crib in front of you, and a small childrens dresser to the south of you.</value>
        </item>
        <item>
          <key>dimsouth</key>
          <value>There is a small childrens dresser in front of you, the brightly painted colours are chipping off. There is a small crib to the east of you.</value>
        </item>
        <item>
          <key>dimwest</key>
          <value>There is a small childrens dresser to the south of you.</value>
        </item>
        <item>
          <key>brightnorth</key>
          <value>You are in a small room. There is a small crib to the east of you, and a wall a few steps forwards.</value>
        </item>
        <item>
          <key>brighteast</key>
          <value>You are in a small room. There is a small crib in front of you, and a small childrens dresser to the south of you. The crib is dusty, and practically rotting away.</value>
        </item>
        <item>
          <key>brightsouth</key>
          <value>You are in a small room. There is a small childrens dresser in front of you, the brightly painted colours are chipping off. There is a small crib to the east of you.</value>
        </item>
        <item>
          <key>brightwest</key>
          <value>You are in a small room. There is a small childrens dresser to the south of you, and a door a few steps forwards.</value>
        </item>
        <item>
          <key>notes</key>
          <value>This is where you find the boy for the 3rd time.</value>
        </item>
      </descriptions>
      <attr name="maven_here" type="boolean">false</attr>
      <description type="script"><![CDATA[
        PrintRoomDesc (False)
        if (player.facing_num = 1 and nursery25.maven_here) {
          if (lantern.light_level <> 0 and Maven.conversation_part = 6) {
            msg ("You think you can see a faint glimmer emanating from under the blanket in the crib.")
          }
        }
      ]]></description>
      <exit name="North102" alias="north" to="defaultroom">
        <inherit name="northdirection" />
        <runscript />
        <script type="script">
          MoveAndFace (nursery34, 0)
        </script>
      </exit>
      <exit name="West94" alias="west" to="defaultroom">
        <inherit name="westdirection" />
        <runscript />
        <visible />
        <script type="script">
          MoveAndFace (nursery26, 3)
        </script>
      </exit>
      <command name="Examine Crib">
        <pattern type="string">(examine|look|check|ex|x|l|look in|open) crib</pattern>
        <script>
          if (nursery25.maven_here) {
            DisableHeart
            if (Maven.conversation_part = 6) {
              msg ("Awesome, you found me again! Maven smiles, widely. Well, I suppose I can keep my promise Maven gestures to the crib, you can see a piece of paper on it now. It looks like another riddle. You thank Maven as you take the paper, and he smiles. No problem, thank you for playing with me! It was a lot of fun, it has been a long time Maven looks into the distance, wistfully. Not many people survive the tests, but I hope you do! Just be careful I hear bad things happen when you change, when you meet him. Maven sighs, Well go on then, dont get stuck here forever like me. I was too young for the tests, I dont know why he picked me back then, experiment maybe? Anyway, good luck out there! Maven vanishes into thin air.")
              Maven.conversation_part = 7
              nursery25.maven_here = False
              EndNursery
            }
          }
          else {
            msg ("There's nothing particularly interesting about the crib.")
          }
        </script>
      </command>
    </object>
    <object name="nursery26">
      <inherit name="editor_room" />
      <usedefaultprefix />
      <descriptions type="stringdictionary">
        <item>
          <key>darknorth</key>
          <value>You cannot see anything. You can feel a hard surface in front of you.</value>
        </item>
        <item>
          <key>darkeast</key>
          <value>You cannot see anything. </value>
        </item>
        <item>
          <key>darksouth</key>
          <value>You cannot see anything. You can feel a piece of furniture in front of you.</value>
        </item>
        <item>
          <key>darkwest</key>
          <value>You cannot see anything. You can feel something in front of you.</value>
        </item>
        <item>
          <key>dimnorth</key>
          <value>There is a shelf holding some old, dusty toys in front of you. There is a door to the west of you.</value>
        </item>
        <item>
          <key>dimeast</key>
          <value>There is a small childrens dresser to the south of you, and a shelf holding some old dusty toys to the north. </value>
        </item>
        <item>
          <key>dimsouth</key>
          <value>There is a small childrens dresser in front of you, all of the paint is chipping off of it. There is a door to the west of you.</value>
        </item>
        <item>
          <key>dimwest</key>
          <value>There is a door in front of you, a small dresser to the south of you, and a shelf holding some toys to the north of you.</value>
        </item>
        <item>
          <key>brightnorth</key>
          <value>You are in a small room. There is a shelf holding some old, dusty toys in front of you. There is a door to the west of you. You think you see something move on the shelf, but when you check again there doesnt seem to be anything.</value>
        </item>
        <item>
          <key>brighteast</key>
          <value>You are in a small room. There is a small childrens dresser to the south of you, a shelf holding some old dusty toys to the south, and a small crib a few steps forwards.</value>
        </item>
        <item>
          <key>brightsouth</key>
          <value>You are in a small room. There is a small childrens dresser in front of you, all of the paint is chipping off of it. There is a door to the west of you. There is a small crib a few steps to the east of you.</value>
        </item>
        <item>
          <key>brightwest</key>
          <value>You are in a small room. There is a door in front of you, a small dresser to the south of you, and a shelf holding some toys to the north of you.</value>
        </item>
      </descriptions>
      <description type="script">
        PrintRoomDesc (False)
      </description>
      <enter type="script">
        geoffrey_turn_script.enabled = false
      </enter>
      <exit name="East98" alias="east" to="defaultroom">
        <inherit name="eastdirection" />
        <runscript />
        <script type="script">
          MoveAndFace (nursery25, 1)
        </script>
      </exit>
      <exit name="West95" alias="west" to="defaultroom">
        <inherit name="westdirection" />
        <runscript />
        <visible />
        <script type="script">
          MoveAndFace (nursery27, 3)
        </script>
      </exit>
    </object>
    <object name="nursery27">
      <inherit name="editor_room" />
      <usedefaultprefix />
      <descriptions type="stringdictionary">
        <item>
          <key>darknorth</key>
          <value>You cannot see anything.</value>
        </item>
        <item>
          <key>darkeast</key>
          <value>You cannot see anything. You can feel something in front of you.</value>
        </item>
        <item>
          <key>darksouth</key>
          <value>You cannot see anything.</value>
        </item>
        <item>
          <key>darkwest</key>
          <value>You cannot see anything.</value>
        </item>
        <item>
          <key>dimnorth</key>
          <value>There is a door to the east of you.</value>
        </item>
        <item>
          <key>dimeast</key>
          <value>There is a door in front of you. </value>
        </item>
        <item>
          <key>dimsouth</key>
          <value>There is a door to the east of you, and a wall a few steps forwards. There are some noises coming from a few steps behind you.</value>
        </item>
        <item>
          <key>dimwest</key>
          <value>There is a wall a few steps south of you. </value>
        </item>
        <item>
          <key>brightnorth</key>
          <value>There is a door to the east of you, you hear some noises coming from a few steps forwards, and can see a glimmer of light on the ground a few steps forwards.</value>
        </item>
        <item>
          <key>brighteast</key>
          <value>There is a door in front of you. You can hear some noises coming from a few steps to the north. </value>
        </item>
        <item>
          <key>brightsouth</key>
          <value>There is a door to the east of you, and a wall a few steps forwards. There are some noises coming from a few steps behind you.</value>
        </item>
        <item>
          <key>brightwest</key>
          <value>There is a wall a few steps south of you. There are some noises coming from the north of you.</value>
        </item>
      </descriptions>
      <description type="script">
        PrintRoomDesc (False)
      </description>
      <enter type="script">
        geoffrey_turn_script.enabled = true
      </enter>
      <exit name="North104" alias="north" to="defaultroom">
        <inherit name="northdirection" />
        <runscript />
        <script type="script">
          MoveAndFace (nursery35, 0)
        </script>
      </exit>
      <exit name="East99" alias="east" to="defaultroom">
        <inherit name="eastdirection" />
        <runscript />
        <script type="script">
          MoveAndFace (nursery26, 1)
        </script>
      </exit>
      <exit name="South103" alias="south" to="defaultroom">
        <inherit name="southdirection" />
        <runscript />
        <script type="script">
          MoveAndFace (nursery21, 2)
        </script>
      </exit>
      <exit name="West98" alias="west" to="defaultroom">
        <inherit name="westdirection" />
        <runscript />
        <visible />
        <script type="script">
          MoveAndFace (nursery28, 3)
        </script>
      </exit>
    </object>
    <object name="nursery28">
      <inherit name="editor_room" />
      <usedefaultprefix />
      <descriptions type="stringdictionary">
        <item>
          <key>darknorth</key>
          <value>You cannot see anything.</value>
        </item>
        <item>
          <key>darkeast</key>
          <value>You cannot see anything.</value>
        </item>
        <item>
          <key>darksouth</key>
          <value>You cannot see anything.</value>
        </item>
        <item>
          <key>darkwest</key>
          <value>You cannot see anything.</value>
        </item>
        <item>
          <key>dimnorth</key>
          <value>You think you are in the middle of the room. You can hear some noises coming from the northeast corner.</value>
        </item>
        <item>
          <key>dimeast</key>
          <value>You think you are in the middle of the room.</value>
        </item>
        <item>
          <key>dimsouth</key>
          <value>You think you are in the middle of the room. There is a childrens toy chest to the southwest of you.</value>
        </item>
        <item>
          <key>dimwest</key>
          <value>You think you are in the middle of the room. There is a childrens toy chest to the southwest of you.</value>
        </item>
        <item>
          <key>brightnorth</key>
          <value>You think you are in the middle of the room. You can hear some noises coming from the northeast corner.</value>
        </item>
        <item>
          <key>brighteast</key>
          <value>You think you are in the middle of the room. You can see a door a few steps forwards.</value>
        </item>
        <item>
          <key>brightsouth</key>
          <value>You think you are in the middle of the room. There is a childrens toy chest to the southwest of you, and a wall a few steps ahead.</value>
        </item>
        <item>
          <key>brightwest</key>
          <value>You think you are in the middle of the room. There is a childrens toy chest to the southwest of you. You can hear some noises coming from the northeast corner of the room.</value>
        </item>
      </descriptions>
      <description type="script">
        PrintRoomDesc (False)
      </description>
      <exit name="North107" alias="north" to="defaultroom">
        <inherit name="northdirection" />
        <runscript />
        <script type="script">
          MoveAndFace (nursery36, 0)
        </script>
      </exit>
      <exit name="East105" alias="east" to="defaultroom">
        <inherit name="eastdirection" />
        <runscript />
        <script type="script">
          MoveAndFace (nursery27, 1)
        </script>
      </exit>
      <exit name="South106" alias="south" to="defaultroom">
        <inherit name="southdirection" />
        <runscript />
        <script type="script">
          MoveAndFace (nursery22, 2)
        </script>
      </exit>
      <exit name="West106" alias="west" to="defaultroom">
        <inherit name="westdirection" />
        <runscript />
        <visible />
        <script type="script">
          MoveAndFace (nursery29, 3)
        </script>
      </exit>
    </object>
    <object name="nursery29">
      <inherit name="editor_room" />
      <usedefaultprefix />
      <descriptions type="stringdictionary">
        <item>
          <key>darknorth</key>
          <value>You cannot see anything.</value>
        </item>
        <item>
          <key>darkeast</key>
          <value>You cannot see anything.</value>
        </item>
        <item>
          <key>darksouth</key>
          <value>You cannot see anything. You can feel a piece of furniture in front of you, it is covered in cobwebs, and they stick to your skin.</value>
        </item>
        <item>
          <key>darkwest</key>
          <value>You cannot see anything.</value>
        </item>
        <item>
          <key>dimnorth</key>
          <value>There is a small table to the northwest of you.</value>
        </item>
        <item>
          <key>dimeast</key>
          <value>There is a childrens toy chest to the south of you. </value>
        </item>
        <item>
          <key>dimsouth</key>
          <value>There is a childrens toy chest in front of you, it is covered in cobwebs.</value>
        </item>
        <item>
          <key>dimwest</key>
          <value>There is a childrens toy chest to the south of you, you see a spider from it, past your feet, on the ground. There is a wall a few steps forwards.</value>
        </item>
        <item>
          <key>brightnorth</key>
          <value>There is a small table to the northwest of you.</value>
        </item>
        <item>
          <key>brighteast</key>
          <value>There is a childrens toy chest to the south of you. You can hear some noises coming from the northeast corner. </value>
        </item>
        <item>
          <key>brightsouth</key>
          <value>There is a childrens toy chest in front of you, it is covered in cobwebs. There is a wall a few steps to the west of you.</value>
        </item>
        <item>
          <key>brightwest</key>
          <value>There is a childrens toy chest to the south of you, you see a spider from it, past your feet, on the ground. There is a wall a few steps forwards. </value>
        </item>
      </descriptions>
      <description type="script"><![CDATA[
        PrintRoomDesc (False)
        if (not oil4.parent = null and lantern.light_level > 0) {
          if (player.facing_num = 0 or player.facing_num = 3) {
            msg ("There is a cask of oil sitting on the table to the northwest.")
          }
        }
      ]]></description>
      <exit name="North113" alias="north" to="defaultroom">
        <inherit name="northdirection" />
        <runscript />
        <script type="script">
          MoveAndFace (nursery37, 0)
        </script>
      </exit>
      <exit name="East107" alias="east" to="defaultroom">
        <inherit name="eastdirection" />
        <runscript />
        <script type="script">
          MoveAndFace (nursery28, 1)
        </script>
      </exit>
      <exit name="West107" alias="west" to="defaultroom">
        <inherit name="westdirection" />
        <runscript />
        <visible />
        <script type="script">
          MoveAndFace (nursery30, 3)
        </script>
      </exit>
    </object>
    <object name="nursery30">
      <inherit name="editor_room" />
      <usedefaultprefix />
      <descriptions type="stringdictionary">
        <item>
          <key>darknorth</key>
          <value>You cannot see anything. You can feel some kind of table in front of you.</value>
        </item>
        <item>
          <key>darkeast</key>
          <value>You cannot see anything.</value>
        </item>
        <item>
          <key>darksouth</key>
          <value>You cannot see anything. You can feel something covered in spider webs in front of you. </value>
        </item>
        <item>
          <key>darkwest</key>
          <value>You cannot see anything. You can feel a wall in front of you.</value>
        </item>
        <item>
          <key>dimnorth</key>
          <value>There is a small table in front of you, and a wall to the west.</value>
        </item>
        <item>
          <key>dimeast</key>
          <value>There is a small table to the north of you. There is a childrens toy chest to the south of you.</value>
        </item>
        <item>
          <key>dimsouth</key>
          <value>There is a childrens toy chest in front of you, it is covered in cobwebs. There is a wall to the west of you.</value>
        </item>
        <item>
          <key>dimwest</key>
          <value>There is a wall in front of you. There is a small table to the north of you, and a childrens toy chest to the south. </value>
        </item>
        <item>
          <key>brightnorth</key>
          <value>There is a small table in front of you, and a wall to the west. You can hear some noises coming from the northeast corner of the room.</value>
        </item>
        <item>
          <key>brighteast</key>
          <value>There is a small table to the north of you. There is a childrens toy chest to the south of you, it is covered in spider webs. </value>
        </item>
        <item>
          <key>brightsouth</key>
          <value>There is a childrens toy chest in front of you, it is covered in cobwebs. There is a wall to the west of you. You can hear some noises coming from the northeast corner of the room.</value>
        </item>
        <item>
          <key>brightwest</key>
          <value>There is a wall in front of you. There is a small table to the north of you, and a childrens toy chest to the south.</value>
        </item>
      </descriptions>
      <description type="script"><![CDATA[
        PrintRoomDesc (False)
        if (not oil4.parent = null and lantern.light_level > 0) {
          if (player.facing_num = 0) {
            msg ("There is a cask of oil sitting on the table in front of you.")
          }
          else if (player.facing_num <> 2) {
            msg ("There is a cask of oil sitting on the table to the north.")
          }
        }
      ]]></description>
      <exit name="East108" alias="east" to="defaultroom">
        <inherit name="eastdirection" />
        <runscript />
        <script type="script">
          MoveAndFace (nursery29, 1)
        </script>
      </exit>
      <object name="oil4">
        <inherit name="editor_object" />
        <alt type="stringlist">
          <value>cask</value>
        </alt>
        <alias>oil</alias>
        <scenery />
        <feature_usegive />
        <take type="script">
          GetOil (oil4)
        </take>
        <use type="script">
          GetOil (oil4)
        </use>
      </object>
    </object>
    <object name="nursery31">
      <inherit name="editor_room" />
      <usedefaultprefix />
      <descriptions type="stringdictionary">
        <item>
          <key>darknorth</key>
          <value>You cannot see anything.</value>
        </item>
        <item>
          <key>darkeast</key>
          <value>You cannot see anything. You can feel a wall in front of you.</value>
        </item>
        <item>
          <key>darksouth</key>
          <value>You cannot see anything.</value>
        </item>
        <item>
          <key>darkwest</key>
          <value>You cannot see anything. You can feel something in front of you.</value>
        </item>
        <item>
          <key>dimnorth</key>
          <value>You are in a narrow hallway. There is a door to the west of you, and a wall to the east.</value>
        </item>
        <item>
          <key>dimeast</key>
          <value>You are in a narrow hallway, there is a wall in front of you.</value>
        </item>
        <item>
          <key>dimsouth</key>
          <value>You are in a narrow hallway, there is a door to the west of you, and a wall to the east.</value>
        </item>
        <item>
          <key>dimwest</key>
          <value>You are in a narrow hallway, there is a door in front of you.</value>
        </item>
        <item>
          <key>brightnorth</key>
          <value>You are in a narrow hallway. There is a door to the west of you, and a wall to the east.</value>
        </item>
        <item>
          <key>brighteast</key>
          <value>You are in a narrow hallway, there is a wall in front of you.</value>
        </item>
        <item>
          <key>brightsouth</key>
          <value>You are in a narrow hallway. There is a door to the west of you, and a wall to the east.</value>
        </item>
        <item>
          <key>brightwest</key>
          <value>You are in a narrow hallway, there is a door in front of you.</value>
        </item>
      </descriptions>
      <door_closed />
      <door_locked />
      <description type="script">
        PrintRoomDesc (False)
      </description>
      <exit name="North121" alias="north" to="defaultroom">
        <inherit name="northdirection" />
        <runscript />
        <script type="script">
          MoveAndFace (nursery38, 0)
        </script>
      </exit>
      <exit name="South120" alias="south" to="defaultroom">
        <inherit name="southdirection" />
        <runscript />
        <script type="script">
          MoveAndFace (nursery23, 2)
        </script>
      </exit>
      <exit name="West121" alias="west" to="defaultroom">
        <inherit name="westdirection" />
        <runscript />
        <visible />
        <script type="script">
          if (nursery31.door_closed) {
            msg ("A closed door blocks your way.")
          }
          else {
            MoveAndFace (nursery32, 3)
            Laila.paused = True
            if (game.debug) {
              msg ("DEBUG: pause Laila")
            }
          }
        </script>
      </exit>
      <command name="Open door6">
        <pattern type="string">(open|push|kick|hit|punch) door</pattern>
        <script>
          if (nursery31.door_locked) {
            msg ("You turn the handle but find the door locked.")
          }
          else {
            if (nursery31.door_closed) {
              msg ("The door swings open.")
              nursery31.door_closed = False
            }
            else {
              msg ("The door is already open.")
            }
          }
        </script>
      </command>
      <command name="Shut door6">
        <pattern type="string">(close|shut|lock) door</pattern>
        <script>
          if (nursery31.door_closed) {
            msg ("The door is already closed.")
          }
          else {
            nursery31.door_closed = True
            msg ("You close the door.")
          }
        </script>
      </command>
    </object>
    <object name="nursery32">
      <inherit name="editor_room" />
      <usedefaultprefix />
      <descriptions type="stringdictionary">
        <item>
          <key>darknorth</key>
          <value>You cannot see anything.</value>
        </item>
        <item>
          <key>darkeast</key>
          <value>You cannot see anything. You can feel something in front of you.</value>
        </item>
        <item>
          <key>darksouth</key>
          <value>You cannot see anything.</value>
        </item>
        <item>
          <key>darkwest</key>
          <value>You cannot see anything.</value>
        </item>
        <item>
          <key>dimnorth</key>
          <value>There is a side table to the northwest, and a wall a few steps forwards.</value>
        </item>
        <item>
          <key>dimeast</key>
          <value>There is a door in front of you.</value>
        </item>
        <item>
          <key>dimsouth</key>
          <value>There is a door to the east of you. There is a pile of toys on a small table to the southwest.</value>
        </item>
        <item>
          <key>dimwest</key>
          <value>There is a large mound of toys a few steps in front of you. There is a doll in front of them all, wearing a dress with little lambs on it. You could have sworn she just blinked.</value>
        </item>
        <item>
          <key>brightnorth</key>
          <value>There is a side table to the northwest, and a wall a few steps forwards. You are in a small room. You feel something watching you. </value>
        </item>
        <item>
          <key>brighteast</key>
          <value>There is a door in front of you. You are in a small room. You think something is watching you.</value>
        </item>
        <item>
          <key>brightsouth</key>
          <value>There is a door to the east of you. There is a pile of toys on a small table to the southwest. You are in a small room.</value>
        </item>
        <item>
          <key>brightwest</key>
          <value>You are in a small room. There is a large mound of toys a few steps in front of you. There is a doll in front of them all, wearing a dress with little lambs on it. You could have sworn she just blinked.</value>
        </item>
      </descriptions>
      <description type="script"><![CDATA[
        PrintRoomDesc (False)
        if (not oil5.parent = null and lantern.light_level > 0) {
          if (player.facing_num = 0 or player.facing_num = 3) {
            msg ("There is a cask of oil sitting on the table to the northwest.")
          }
        }
      ]]></description>
      <exit name="North123" alias="north" to="defaultroom">
        <inherit name="northdirection" />
        <runscript />
        <script type="script">
          MoveAndFace (nursery39, 0)
        </script>
      </exit>
      <exit name="East123" alias="east" to="defaultroom">
        <inherit name="eastdirection" />
        <runscript />
        <script type="script">
          if (nursery31.door_closed) {
            msg ("A closed door blocks your way.")
          }
          else {
            MoveAndFace (nursery31, 1)
            Laila.paused = False
            if (game.debug) {
              msg ("DEBUG: unpause Laila")
            }
          }
        </script>
      </exit>
      <exit name="South123" alias="south" to="defaultroom">
        <inherit name="southdirection" />
        <runscript />
        <script type="script">
          MoveAndFace (nursery24, 2)
        </script>
      </exit>
      <exit name="West122" alias="west" to="defaultroom">
        <inherit name="westdirection" />
        <runscript />
        <visible />
        <script type="script">
          MoveAndFace (nursery33, 3)
        </script>
      </exit>
      <command name="Open door7">
        <pattern type="string">(open|push|kick|hit|punch) door</pattern>
        <script>
          if (nursery31.door_closed) {
            msg ("The door swings open.")
            nursery31.door_closed = False
          }
          else {
            msg ("The door is already open.")
          }
        </script>
      </command>
      <command name="Shut door7">
        <pattern type="string">(close|shut|lock) door</pattern>
        <script>
          if (nursery31.door_closed) {
            msg ("The door is already closed.")
          }
          else {
            nursery31.door_closed = True
            msg ("You close the door.")
          }
        </script>
      </command>
    </object>
    <object name="nursery33">
      <inherit name="editor_room" />
      <usedefaultprefix />
      <descriptions type="stringdictionary">
        <item>
          <key>darknorth</key>
          <value>You cannot see anything. You can feel a table of some sort in front of you.</value>
        </item>
        <item>
          <key>darkeast</key>
          <value>You cannot see anything.</value>
        </item>
        <item>
          <key>darksouth</key>
          <value>You cannot see anything. You can feel a table of some sort in front of you.</value>
        </item>
        <item>
          <key>darkwest</key>
          <value>You cannot see anything. You can feel a table of some kind in front of you.</value>
        </item>
        <item>
          <key>dimnorth</key>
          <value>There is a small table in front of you.</value>
        </item>
        <item>
          <key>dimeast</key>
          <value>You are surrounding by toys on tables. There is a door a few steps forwards.</value>
        </item>
        <item>
          <key>dimsouth</key>
          <value>There is a small table in front of you, covered in toys. There are stuffed teddy bears missing eyes, limbs, and insides strewn about. There is a doll sitting in front of all the other toys to the west of you.</value>
        </item>
        <item>
          <key>dimwest</key>
          <value>There is a small cabinet in front of you. There is a doll sitting on it, wearing a little lamb dress. Did she just move?</value>
        </item>
        <item>
          <key>brightnorth</key>
          <value>You are in a small room. There is a small table in front of you. You feel like something is staring at you.</value>
        </item>
        <item>
          <key>brighteast</key>
          <value>You are in a small room, surrounding by toys on tables. There is a door a few steps forwards.</value>
        </item>
        <item>
          <key>brightsouth</key>
          <value>You are in a small room. There is a small table in front of you, covered in toys. There are stuffed teddy bears missing eyes, limbs, and insides strewn about. There is a doll sitting in front of all the other toys to the west of you. She is wearing a little lamb dress.</value>
        </item>
        <item>
          <key>brightwest</key>
          <value>You are in a small room. There is a small cabinet in front of you. There is a doll sitting on it, wearing a little lamb dress.</value>
        </item>
        <item>
          <key>notes</key>
          <value>Boy hides here for the 1st time. Find him facing west and inspecting cabinet.</value>
        </item>
      </descriptions>
      <attr name="maven_here" type="boolean">false</attr>
      <description type="script"><![CDATA[
        PrintRoomDesc (False)
        if (not oil5.parent = null and lantern.light_level > 0) {
          if (player.facing_num = 0) {
            msg ("There is a cask of oil sitting on the table in front of you.")
          }
          else if (player.facing_num <> 2) {
            msg ("There is a cask of oil sitting on the table to the north.")
          }
        }
        if (player.facing_num = 3 and nursery33.maven_here) {
          if (lantern.light_level <> 0 and Maven.conversation_part = 2) {
            msg ("You think you see a faint glow emanating from the cabinet.")
          }
          else if (Maven.conversation_part = 3) {
            msg ("Maven is standing in front of you.")
          }
        }
      ]]></description>
      <exit name="East124" alias="east" to="defaultroom">
        <inherit name="eastdirection" />
        <runscript />
        <script type="script">
          MoveAndFace (nursery32, 1)
        </script>
      </exit>
      <command name="Examine Cabinet">
        <pattern type="string">(examine|look|check|ex|x|l|look in|open) cabinet</pattern>
        <script>
          if (nursery33.maven_here) {
            DisableHeart
            if (Maven.conversation_part = 2) {
              msg ("You found me! You found me! I was sure you would leave like the others. You look at Maven, puzzled for a moment. There have always been more like you, yknow. The king must go on, or whatever it is he says. Hes a big ol dummy anyway. Maven twiddles his thumbs and looks up at you shyly, Can we play again? ")
              Maven.conversation_part = 3
            }
            else if (Maven.conversation_part = 3) {
              msg ("'So will you play again?' he asks looking more excited.")
            }
          }
          else {
            msg ("There's nothing particularly interesting about the cabinet.")
          }
        </script>
      </command>
      <command name="Say Yes3">
        <pattern type="string">(say yes|yes|tell boy yes|tell ghost yes|accept|accept game|play|play with boy|play with ghost)</pattern>
        <script>
          if (Maven.conversation_part = 3) {
            DisableHeart
            msg ("Youre the best! Okay well, just be careful of Geoffrey He likes the quiet, just count to five before you take a step! ")
            msg ("Maven skips away again but you can hear him singing, 'Ring-a-ring o' roses, A pocket full of posies, A-tishoo! A-tishoo! We all fall down.'")
            nursery33.maven_here = False
            nursery61.maven_here = True
            Maven.conversation_part = 4
          }
          else {
            msg ("I don't understand your command.")
          }
        </script>
      </command>
      <command name="Talk To Maven">
        <unresolved type="string"></unresolved>
        <pattern type="string">(talk|talk to|talk to boy|talk to ghost|speak|speak to|speak to boy|speak to ghost)</pattern>
        <script>
          if (nursery33.maven_here and Maven.conversation_part = 3) {
            DisableHeart
            msg ("'So will you play again?' he asks looking more excited.")
          }
          else {
            msg ("I don't understand your command.")
          }
        </script>
      </command>
    </object>
    <object name="nursery34">
      <inherit name="editor_room" />
      <usedefaultprefix />
      <descriptions type="stringdictionary">
        <item>
          <key>darknorth</key>
          <value>You cannot see anything. You can feel a wall in front of you.</value>
        </item>
        <item>
          <key>darkeast</key>
          <value>You cannot see anything. You can feel some kind of furniture in front of you.</value>
        </item>
        <item>
          <key>darksouth</key>
          <value>You cannot see anything.</value>
        </item>
        <item>
          <key>darkwest</key>
          <value>You cannot see anything. You can feel some kind of shelf in front of you.</value>
        </item>
        <item>
          <key>dimnorth</key>
          <value>There is a wall in front of you, a small crib to the east of you, and a shelf with some old toys sitting on it to the west of you. </value>
        </item>
        <item>
          <key>dimeast</key>
          <value>There is a crib in front of you, and a wall to the north of you.</value>
        </item>
        <item>
          <key>dimsouth</key>
          <value>There is a small crib to the east of you, a shelf with some old toys on it to the west.</value>
        </item>
        <item>
          <key>dimwest</key>
          <value>There is a shelf in front of you, with some old toys laying on it. There is a wall to the north of you.</value>
        </item>
        <item>
          <key>brightnorth</key>
          <value>You are in a small room. There is a wall in front of you, a small crib to the east of you, and a shelf with some old toys sitting on it to the west of you. </value>
        </item>
        <item>
          <key>brighteast</key>
          <value>You are in a small room. There is a crib in front of you, and a wall to the north of you.</value>
        </item>
        <item>
          <key>brightsouth</key>
          <value>You are in a small room. There is a small crib to the east of you, a shelf with some old toys on it to the west. There is a small childrens dresser a few steps forwards.</value>
        </item>
        <item>
          <key>brightwest</key>
          <value>You are in a small room. There is a shelf in front of you, with some old toys laying on it. There is a wall to the north of you.</value>
        </item>
      </descriptions>
      <description type="script">
        PrintRoomDesc (False)
      </description>
      <exit name="South125" alias="south" to="defaultroom">
        <inherit name="southdirection" />
        <runscript />
        <script type="script">
          MoveAndFace (nursery25, 2)
        </script>
      </exit>
    </object>
    <object name="nursery35">
      <inherit name="editor_room" />
      <usedefaultprefix />
      <descriptions type="stringdictionary">
        <item>
          <key>darknorth</key>
          <value>You cannot see anything.</value>
        </item>
        <item>
          <key>darkeast</key>
          <value>You cannot see anything. You can feel a wall in front of you.</value>
        </item>
        <item>
          <key>darksouth</key>
          <value>You cannot see anything.</value>
        </item>
        <item>
          <key>darkwest</key>
          <value>You cannot see anything.</value>
        </item>
        <item>
          <key>dimnorth</key>
          <value>There is a wall to the east of you. You can hear some strange noises coming from a few steps forwards.</value>
        </item>
        <item>
          <key>dimeast</key>
          <value>There is a wall in front of you. You can hear some strange noises a few steps to the north of you.</value>
        </item>
        <item>
          <key>dimsouth</key>
          <value>There is a wall to the east of you. You hear a childs voice murmuring from little ways behind you.</value>
        </item>
        <item>
          <key>dimwest</key>
          <value>There is not much around you.</value>
        </item>
        <item>
          <key>brightnorth</key>
          <value>There is a wall to the east of you. You can hear some strange noises coming from a few steps forwards.</value>
        </item>
        <item>
          <key>brighteast</key>
          <value>There is a wall in front of you. You can hear some strange noises a few steps to the north of you.</value>
        </item>
        <item>
          <key>brightsouth</key>
          <value>There is a wall to the east of you. You hear a childs voice murmuring from little ways behind you.</value>
        </item>
        <item>
          <key>brightwest</key>
          <value>There is not much around you. You hear some movement to the north of you.</value>
        </item>
      </descriptions>
      <description type="script">
        PrintRoomDesc (False)
      </description>
      <exit name="North126" alias="north" to="defaultroom">
        <inherit name="northdirection" />
        <runscript />
        <script type="script">
          MoveAndFace (nursery40, 0)
        </script>
      </exit>
      <exit name="South126" alias="south" to="defaultroom">
        <inherit name="southdirection" />
        <runscript />
        <script type="script">
          MoveAndFace (nursery27, 2)
        </script>
      </exit>
      <exit name="West125" alias="west" to="defaultroom">
        <inherit name="westdirection" />
        <runscript />
        <visible />
        <script type="script">
          MoveAndFace (nursery36, 3)
        </script>
      </exit>
    </object>
    <object name="nursery36">
      <inherit name="editor_room" />
      <usedefaultprefix />
      <descriptions type="stringdictionary">
        <item>
          <key>darknorth</key>
          <value>You cannot see anything.</value>
        </item>
        <item>
          <key>darkeast</key>
          <value>You cannot see anything.</value>
        </item>
        <item>
          <key>darksouth</key>
          <value>You cannot see anything.</value>
        </item>
        <item>
          <key>darkwest</key>
          <value>You cannot see anything.</value>
        </item>
        <item>
          <key>dimnorth</key>
          <value>There is not much around you, you think you are in the middle of the room.</value>
        </item>
        <item>
          <key>dimeast</key>
          <value>There is not much around you, you think you are in the middle of the room.</value>
        </item>
        <item>
          <key>dimsouth</key>
          <value>There is not much around you, you think you are in the middle of the room. You can hear the tapping of a toy on the ground.</value>
        </item>
        <item>
          <key>dimwest</key>
          <value>There is not much around you, you think you are in the middle of the room.</value>
        </item>
        <item>
          <key>brightnorth</key>
          <value>There is not much around you, you think you are in the middle of the room. You can hear some noise coming from the northeast corner. </value>
        </item>
        <item>
          <key>brighteast</key>
          <value>There is not much around you, you think you are in the middle of the room.</value>
        </item>
        <item>
          <key>brightsouth</key>
          <value>There is not much around you, you think you are in the middle of the room. You can hear the tapping of a toy on the ground.</value>
        </item>
        <item>
          <key>brightwest</key>
          <value>There is not much around you, you think you are in the middle of the room. You think you can see a small table a few spaces ahead.</value>
        </item>
      </descriptions>
      <description type="script">
        PrintRoomDesc (False)
      </description>
      <exit name="North127" alias="north" to="defaultroom">
        <inherit name="northdirection" />
        <runscript />
        <script type="script">
          MoveAndFace (nursery41, 0)
        </script>
      </exit>
      <exit name="East127" alias="east" to="defaultroom">
        <inherit name="eastdirection" />
        <runscript />
        <script type="script">
          MoveAndFace (nursery35, 1)
        </script>
      </exit>
      <exit name="South127" alias="south" to="defaultroom">
        <inherit name="southdirection" />
        <runscript />
        <script type="script">
          MoveAndFace (nursery28, 2)
        </script>
      </exit>
      <exit name="West126" alias="west" to="defaultroom">
        <inherit name="westdirection" />
        <runscript />
        <visible />
        <script type="script">
          MoveAndFace (nursery37, 3)
        </script>
      </exit>
    </object>
    <object name="nursery37">
      <inherit name="editor_room" />
      <usedefaultprefix />
      <descriptions type="stringdictionary">
        <item>
          <key>darknorth</key>
          <value>You cannot see anything.</value>
        </item>
        <item>
          <key>darkeast</key>
          <value>You cannot see anything.</value>
        </item>
        <item>
          <key>darksouth</key>
          <value>You cannot see anything.</value>
        </item>
        <item>
          <key>darkwest</key>
          <value>You cannot see anything. You can feel a table of some sort in front of you.</value>
        </item>
        <item>
          <key>dimnorth</key>
          <value>There is a small table to the west of you.</value>
        </item>
        <item>
          <key>dimeast</key>
          <value>There is not much around you. </value>
        </item>
        <item>
          <key>dimsouth</key>
          <value>There is a small table to the west of you.</value>
        </item>
        <item>
          <key>dimwest</key>
          <value>There is a small table in front of you.</value>
        </item>
        <item>
          <key>brightnorth</key>
          <value>There is a small table to the west of you. You can hear some noises coming from the northeast corner of the room.</value>
        </item>
        <item>
          <key>brighteast</key>
          <value>There is not much around you. You can hear some toys being clacked together in the northeast corner of the room.</value>
        </item>
        <item>
          <key>brightsouth</key>
          <value>There is a small table to the west of you.</value>
        </item>
        <item>
          <key>brightwest</key>
          <value>There is a small table in front of you.</value>
        </item>
      </descriptions>
      <description type="script"><![CDATA[
        PrintRoomDesc (False)
        if (not oil4.parent = null and lantern.light_level > 0) {
          if (player.facing_num = 3) {
            msg ("There is a cask of oil sitting on the table in front of you.")
          }
          else if (player.facing_num <> 1) {
            msg ("There is a cask of oil sitting on the table to the west.")
          }
        }
      ]]></description>
      <exit name="North128" alias="north" to="defaultroom">
        <inherit name="northdirection" />
        <runscript />
        <script type="script">
          MoveAndFace (nursery42, 0)
        </script>
      </exit>
      <exit name="East128" alias="east" to="defaultroom">
        <inherit name="eastdirection" />
        <runscript />
        <script type="script">
          MoveAndFace (nursery36, 1)
        </script>
      </exit>
      <exit name="South128" alias="south" to="defaultroom">
        <inherit name="southdirection" />
        <runscript />
        <script type="script">
          MoveAndFace (nursery29, 2)
        </script>
      </exit>
    </object>
    <object name="nursery38">
      <inherit name="editor_room" />
      <usedefaultprefix />
      <descriptions type="stringdictionary">
        <item>
          <key>darknorth</key>
          <value>You cannot see anything.</value>
        </item>
        <item>
          <key>darkeast</key>
          <value>You cannot see anything. You can feel a wall in front of you.</value>
        </item>
        <item>
          <key>darksouth</key>
          <value>You cannot see anything.</value>
        </item>
        <item>
          <key>darkwest</key>
          <value>You cannot see anything. You can feel a wall in front of you.</value>
        </item>
        <item>
          <key>dimnorth</key>
          <value>You are in a narrow hallway, there is a wall to the east, and to the west of you.</value>
        </item>
        <item>
          <key>dimeast</key>
          <value>You are in a narrow hallway, there is a wall in front of you.</value>
        </item>
        <item>
          <key>dimsouth</key>
          <value>You are in a narrow hallway, there is a wall to the east, and to the west of you.</value>
        </item>
        <item>
          <key>dimwest</key>
          <value>You are in a narrow hallway, there is a wall in front of you.</value>
        </item>
        <item>
          <key>brightnorth</key>
          <value>You are in a narrow hallway, there is a wall to the east, and to the west of you.</value>
        </item>
        <item>
          <key>brighteast</key>
          <value>You are in a narrow hallway, there is a wall in front of you.</value>
        </item>
        <item>
          <key>brightsouth</key>
          <value>You are in a narrow hallway, there is a wall to the east, and to the west of you.</value>
        </item>
        <item>
          <key>brightwest</key>
          <value>You are in a narrow hallway, there is a wall in front of you.</value>
        </item>
      </descriptions>
      <description type="script">
        PrintRoomDesc (False)
      </description>
      <exit name="North129" alias="north" to="defaultroom">
        <inherit name="northdirection" />
        <runscript />
        <script type="script">
          MoveAndFace (nursery44, 0)
        </script>
      </exit>
      <exit name="South129" alias="south" to="defaultroom">
        <inherit name="southdirection" />
        <runscript />
        <script type="script">
          MoveAndFace (nursery31, 2)
        </script>
      </exit>
    </object>
    <object name="nursery39">
      <inherit name="editor_room" />
      <usedefaultprefix />
      <descriptions type="stringdictionary">
        <item>
          <key>darknorth</key>
          <value>You cannot see anything. You can feel a wall in front of you.</value>
        </item>
        <item>
          <key>darkeast</key>
          <value>You cannot see anything. You can feel a wall in front of you.</value>
        </item>
        <item>
          <key>darksouth</key>
          <value>You cannot see anything. </value>
        </item>
        <item>
          <key>darkwest</key>
          <value>You cannot see anything. You can feel a table in front of you.</value>
        </item>
        <item>
          <key>dimnorth</key>
          <value>There is a wall in front of you, and to the east of you. There is a small table to the west of you.</value>
        </item>
        <item>
          <key>dimeast</key>
          <value>There is a wall in front of you, and to the north of you.</value>
        </item>
        <item>
          <key>dimsouth</key>
          <value>There is a wall to the east of you, and a small table to the west.</value>
        </item>
        <item>
          <key>dimwest</key>
          <value>There is a small table in front of you. There is a wall to the north of you.</value>
        </item>
        <item>
          <key>brightnorth</key>
          <value>There is a wall in front of you, and to the east of you. There is a small table to the west of you. You are in the corner of a small room. </value>
        </item>
        <item>
          <key>brighteast</key>
          <value>There is a wall in front of you, and to the north of you. You are in the corner of a small room.</value>
        </item>
        <item>
          <key>brightsouth</key>
          <value>There is a wall to the east of you, and a small table to the west. You are in the corner of a small room.</value>
        </item>
        <item>
          <key>brightwest</key>
          <value>There is a small table in front of you. There is a wall to the north of you. You are in the corner of a small room.</value>
        </item>
      </descriptions>
      <description type="script"><![CDATA[
        PrintRoomDesc (False)
        if (not oil5.parent = null and lantern.light_level > 0) {
          if (player.facing_num = 3) {
            msg ("There is a cask of oil sitting on the table in front of you.")
          }
          else if (player.facing_num <> 1) {
            msg ("There is a cask of oil sitting on the table to the west.")
          }
        }
      ]]></description>
      <exit name="South130" alias="south" to="defaultroom">
        <inherit name="southdirection" />
        <runscript />
        <script type="script">
          MoveAndFace (nursery32, 2)
        </script>
      </exit>
      <object name="oil5">
        <inherit name="editor_object" />
        <alt type="stringlist">
          <value>cask</value>
        </alt>
        <alias>oil</alias>
        <scenery />
        <feature_usegive />
        <take type="script">
          GetOil (oil5)
        </take>
        <use type="script">
          GetOil (oil5)
        </use>
      </object>
    </object>
    <object name="nursery40">
      <inherit name="editor_room" />
      <usedefaultprefix />
      <descriptions type="stringdictionary">
        <item>
          <key>darknorth</key>
          <value>You cannot see anything. You can hear something moving in front of you.</value>
        </item>
        <item>
          <key>darkeast</key>
          <value>You cannot see anything. You can feel a wall in front of you.</value>
        </item>
        <item>
          <key>darksouth</key>
          <value>You cannot see anything.</value>
        </item>
        <item>
          <key>darkwest</key>
          <value>You cannot see anything.</value>
        </item>
        <item>
          <key>dimnorth</key>
          <value>There is a wall to the east of you. In front of you there is the glimmering figure of a little boy sitting on the ground. He looks irate, and is playing with his toys.</value>
        </item>
        <item>
          <key>dimeast</key>
          <value>There is a wall in front of you. There is a translucent figure of a small boy to the north of you, he looks angry.</value>
        </item>
        <item>
          <key>dimsouth</key>
          <value>There is a wall to the east of you. You can hear noises coming from behind you.</value>
        </item>
        <item>
          <key>dimwest</key>
          <value>There is a translucent, glimmering figure of a small boy to the north of you. He is playing with something, smashing it around violently.</value>
        </item>
        <item>
          <key>brightnorth</key>
          <value>There is a wall to the east of you. In front of you there is the glimmering figure of a little boy sitting on the ground. He looks irate, and is playing with his toys.</value>
        </item>
        <item>
          <key>brighteast</key>
          <value>There is a wall in front of you. There is a translucent figure of a small boy to the north of you, he looks angry.</value>
        </item>
        <item>
          <key>brightsouth</key>
          <value>There is a wall to the east of you. You can hear noises coming from behind you.</value>
        </item>
        <item>
          <key>brightwest</key>
          <value>There is a translucent, glimmering figure of a small boy to the north of you. He is playing with what looks like a bone, smashing it around violently.</value>
        </item>
      </descriptions>
      <description type="script">
        PrintRoomDesc (False)
      </description>
      <exit name="South131" alias="south" to="defaultroom">
        <inherit name="southdirection" />
        <runscript />
        <script type="script">
          MoveAndFace (nursery35, 2)
        </script>
      </exit>
      <exit name="West130" alias="west" to="defaultroom">
        <inherit name="westdirection" />
        <runscript />
        <visible />
        <script type="script">
          MoveAndFace (nursery41, 3)
        </script>
      </exit>
    </object>
    <object name="nursery41">
      <inherit name="editor_room" />
      <usedefaultprefix />
      <descriptions type="stringdictionary">
        <item>
          <key>darknorth</key>
          <value>You cannot see anything. There is something in front of you, but you cant tell what it is.</value>
        </item>
        <item>
          <key>darkeast</key>
          <value>You cannot see anything.</value>
        </item>
        <item>
          <key>darksouth</key>
          <value>You cannot see anything.</value>
        </item>
        <item>
          <key>darkwest</key>
          <value>You cannot see anything.</value>
        </item>
        <item>
          <key>dimnorth</key>
          <value>There is a pile of toys surrounding the base of an anatomical skeleton. There is a translucent figure of a little boy to the east of it who seems to be playing with an arm bone of the skeleton.</value>
        </item>
        <item>
          <key>dimeast</key>
          <value>There is a pile of toys, including an anatomical skeleton to the north of you. There is not much else around you. There is a glimmer of a little boy to the northeast.</value>
        </item>
        <item>
          <key>dimsouth</key>
          <value>There is not much around you. You can hear noises coming from the northeast of you.</value>
        </item>
        <item>
          <key>dimwest</key>
          <value>There is a pile of toys, including an anatomical skeleton to the north of you. There is not much else around you. You can hear noises coming from a bit behind you.</value>
        </item>
        <item>
          <key>brightnorth</key>
          <value>There is a pile of toys surrounding the base of an anatomical skeleton. There is a translucent figure of a little boy to the east of it who seems to be playing with an arm bone of the skeleton.</value>
        </item>
        <item>
          <key>brighteast</key>
          <value>There is a pile of toys, including an anatomical skeleton to the north of you. There is not much else around you. There is a glimmer of a little boy to the northeast. He is murmuring to himself.</value>
        </item>
        <item>
          <key>brightsouth</key>
          <value>There is not much around you. You can hear noises coming from the northeast of you.</value>
        </item>
        <item>
          <key>brightwest</key>
          <value>There is a pile of toys, including an anatomical skeleton to the north of you. There is not much else around you. You can hear noises coming from a bit behind you.</value>
        </item>
      </descriptions>
      <description type="script">
        PrintRoomDesc (False)
      </description>
      <exit name="East132" alias="east" to="defaultroom">
        <inherit name="eastdirection" />
        <runscript />
        <script type="script">
          MoveAndFace (nursery40, 1)
        </script>
      </exit>
      <exit name="South132" alias="south" to="defaultroom">
        <inherit name="southdirection" />
        <runscript />
        <script type="script">
          MoveAndFace (nursery36, 2)
        </script>
      </exit>
      <exit name="West131" alias="west" to="defaultroom">
        <inherit name="westdirection" />
        <runscript />
        <visible />
        <script type="script">
          MoveAndFace (nursery42, 3)
        </script>
      </exit>
    </object>
    <object name="nursery42">
      <inherit name="editor_room" />
      <usedefaultprefix />
      <descriptions type="stringdictionary">
        <item>
          <key>darknorth</key>
          <value>You cannot see anything.</value>
        </item>
        <item>
          <key>darkeast</key>
          <value>You cannot see anything.</value>
        </item>
        <item>
          <key>darksouth</key>
          <value>You cannot see anything.</value>
        </item>
        <item>
          <key>darkwest</key>
          <value>You cannot see anything.</value>
        </item>
        <item>
          <key>dimnorth</key>
          <value>There is a wall a few steps forwards, a pile of toys to the northeast of you, and a small table to the northwest of you. There is a door a few steps to the west of you.</value>
        </item>
        <item>
          <key>dimeast</key>
          <value>There is a pile of toys to the northeast of you. There is not much else around you.</value>
        </item>
        <item>
          <key>dimsouth</key>
          <value>There is a door a few steps to the west of you, and a small table to the southwest.</value>
        </item>
        <item>
          <key>dimwest</key>
          <value>There is a door a few steps forwards, a small table to the southwest, and a small table to the northwest.</value>
        </item>
        <item>
          <key>brightnorth</key>
          <value>There is a wall a few steps forwards, a pile of toys to the northeast of you, and a small table to the northwest of you. There is a door a few steps to the west of you. You can hear movement in the northeast corner of the room.</value>
        </item>
        <item>
          <key>brighteast</key>
          <value>There is a pile of toys to the northeast of you. There is not much else around you. You hear the repeated bashing of something onto the ground coming from the northeast corner of the room.</value>
        </item>
        <item>
          <key>brightsouth</key>
          <value>There is a door a few steps to the west of you and a small table to the southwest.</value>
        </item>
        <item>
          <key>brightwest</key>
          <value>There is a door a few steps forwards, a small table to the southwest, and a small table to the northwest.</value>
        </item>
      </descriptions>
      <description type="script"><![CDATA[
        PrintRoomDesc (False)
        if (not oil4.parent = null and lantern.light_level > 0) {
          if (player.facing_num = 2 or player.facing_num = 3) {
            msg ("There is a cask of oil sitting on the table to the southwest.")
          }
        }
      ]]></description>
      <exit name="North133" alias="north" to="defaultroom">
        <inherit name="northdirection" />
        <runscript />
        <script type="script">
          MoveAndFace (nursery45, 0)
        </script>
      </exit>
      <exit name="East133" alias="east" to="defaultroom">
        <inherit name="eastdirection" />
        <runscript />
        <script type="script">
          MoveAndFace (nursery41, 1)
        </script>
      </exit>
      <exit name="South133" alias="south" to="defaultroom">
        <inherit name="southdirection" />
        <runscript />
        <script type="script">
          MoveAndFace (nursery37, 2)
        </script>
      </exit>
      <exit name="West132" alias="west" to="defaultroom">
        <inherit name="westdirection" />
        <runscript />
        <visible />
        <script type="script">
          MoveAndFace (nursery43, 3)
        </script>
      </exit>
    </object>
    <object name="nursery43">
      <inherit name="editor_room" />
      <usedefaultprefix />
      <descriptions type="stringdictionary">
        <item>
          <key>darknorth</key>
          <value>You cannot see anything. You can feel some kind of table in front of you.</value>
        </item>
        <item>
          <key>darkeast</key>
          <value>You cannot see anything.</value>
        </item>
        <item>
          <key>darksouth</key>
          <value>You cannot see anything. You can feel a table in front of you. It seems like theres something on it.</value>
        </item>
        <item>
          <key>darkwest</key>
          <value>You cannot see anything. You can feel something in front of you.</value>
        </item>
        <item>
          <key>dimnorth</key>
          <value>There is a small end table in front of you, it is old and dusty but doesnt have anything of interest on it. There is a door to the west of you.</value>
        </item>
        <item>
          <key>dimeast</key>
          <value>There is a small table to the north of you, and a table to the south of you. </value>
        </item>
        <item>
          <key>dimsouth</key>
          <value>There is a small table in front of you. There is a door to the west of you.</value>
        </item>
        <item>
          <key>dimwest</key>
          <value>There is a door in front of you. There is a small table to the north of you, and a table to the south of you.</value>
        </item>
        <item>
          <key>brightnorth</key>
          <value>There is a small end table in front of you, it is old and dusty but doesnt have anything of interest on it. There is a door to the west of you.</value>
        </item>
        <item>
          <key>brighteast</key>
          <value>There is a small table to the north of you, and a table to the south of you. There is some noises coming from the northeast corner of the room.</value>
        </item>
        <item>
          <key>brightsouth</key>
          <value>There is a small table in front of you. There is a door to the west of you. There are some noises coming from the northeast corner of the room.</value>
        </item>
        <item>
          <key>brightwest</key>
          <value>There is a door in front of you. There is a small table to the north of you, and a table to the south of you.</value>
        </item>
      </descriptions>
      <description type="script"><![CDATA[
        PrintRoomDesc (False)
        if (not oil4.parent = null and lantern.light_level > 0) {
          if (player.facing_num = 0) {
            msg ("There is a cask of oil sitting on the table in front of you.")
          }
          else if (player.facing_num <> 2) {
            msg ("There is a cask of oil sitting on the table to the north.")
          }
        }
      ]]></description>
      <enter type="script">
        geoffrey_turn_script.enabled = true
      </enter>
      <exit name="East134" alias="east" to="defaultroom">
        <inherit name="eastdirection" />
        <runscript />
        <script type="script">
          MoveAndFace (nursery42, 1)
        </script>
      </exit>
      <exit name="West133" alias="west" to="defaultroom">
        <inherit name="westdirection" />
        <runscript />
        <visible />
        <script type="script">
          if (nursery44.door_closed) {
            msg ("A closed door blocks your way.")
          }
          else {
            MoveAndFace (nursery44, 3)
          }
        </script>
      </exit>
      <command name="Open door8">
        <pattern type="string">(open|push|kick|hit|punch) door</pattern>
        <script>
          if (nursery44.door_closed) {
            msg ("The door swings open.")
            nursery44.door_closed = False
          }
          else {
            msg ("The door is already open.")
          }
        </script>
      </command>
      <command name="Shut door8">
        <pattern type="string">(close|shut|lock) door</pattern>
        <script>
          if (nursery44.door_closed) {
            msg ("The door is already closed.")
          }
          else {
            nursery44.door_closed = True
            msg ("You close the door.")
          }
        </script>
      </command>
    </object>
    <object name="nursery44">
      <inherit name="editor_room" />
      <usedefaultprefix />
      <descriptions type="stringdictionary">
        <item>
          <key>darknorth</key>
          <value>You cannot see anything.</value>
        </item>
        <item>
          <key>darkeast</key>
          <value>You cannot see anything. You can feel a hard surface in front of you.</value>
        </item>
        <item>
          <key>darksouth</key>
          <value>You cannot see anything.</value>
        </item>
        <item>
          <key>darkwest</key>
          <value>You cannot see anything. You can feel a wall in front of you.</value>
        </item>
        <item>
          <key>dimnorth</key>
          <value>You are in a narrow hallway, there is a door to the east of you, and a wall to the west.</value>
        </item>
        <item>
          <key>dimeast</key>
          <value>You are in a narrow hallway, there is a door in front of you.</value>
        </item>
        <item>
          <key>dimsouth</key>
          <value>You are in a narrow hallway, there is a door to the east of you, and a wall to the west.</value>
        </item>
        <item>
          <key>dimwest</key>
          <value>You are in a narrow hallway, there is a wall in front of you.</value>
        </item>
        <item>
          <key>brightnorth</key>
          <value>You are in a narrow hallway, there is a door to the east of you, and a wall to the west.</value>
        </item>
        <item>
          <key>brighteast</key>
          <value>You are in a narrow hallway, there is a door in front of you.</value>
        </item>
        <item>
          <key>brightsouth</key>
          <value>You are in a narrow hallway, there is a door to the east of you, and a wall to the west.</value>
        </item>
        <item>
          <key>brightwest</key>
          <value>You are in a narrow hallway, there is a wall in front of you.</value>
        </item>
      </descriptions>
      <door_closed />
      <door_locked />
      <description type="script">
        PrintRoomDesc (False)
      </description>
      <enter type="script">
        geoffrey_turn_script.enabled = false
      </enter>
      <exit name="North135" alias="north" to="defaultroom">
        <inherit name="northdirection" />
        <runscript />
        <script type="script">
          MoveAndFace (nursery46, 0)
        </script>
      </exit>
      <exit name="East135" alias="east" to="defaultroom">
        <inherit name="eastdirection" />
        <runscript />
        <script type="script">
          if (nursery44.door_closed) {
            msg ("A closed door blocks your way.")
          }
          else {
            MoveAndFace (nursery43, 1)
            Laila.paused = True
            if (game.debug) {
              msg ("DEBUG: pause Laila")
            }
          }
        </script>
      </exit>
      <exit name="South135" alias="south" to="defaultroom">
        <inherit name="southdirection" />
        <runscript />
        <script type="script">
          MoveAndFace (nursery38, 2)
        </script>
      </exit>
      <command name="Open door9">
        <pattern type="string">(open|push|kick|hit|punch) door</pattern>
        <script>
          if (nursery44.door_locked) {
            msg ("You turn the handle but find the door locked.")
          }
          else {
            if (nursery44.door_closed) {
              msg ("The door swings open.")
              nursery44.door_closed = False
            }
            else {
              msg ("The door is already open.")
            }
          }
        </script>
      </command>
      <command name="Shut door9">
        <pattern type="string">(close|shut|lock) door</pattern>
        <script>
          if (nursery44.door_closed) {
            msg ("The door is already closed.")
          }
          else {
            nursery44.door_closed = True
            msg ("You close the door.")
          }
        </script>
      </command>
    </object>
    <object name="nursery45">
      <inherit name="editor_room" />
      <usedefaultprefix />
      <descriptions type="stringdictionary">
        <item>
          <key>darknorth</key>
          <value>You cannot see anything. You can feel a wall in front of you.</value>
        </item>
        <item>
          <key>darkeast</key>
          <value>You cannot see anything. You can feel something in front of you.</value>
        </item>
        <item>
          <key>darksouth</key>
          <value>You cannot see anything.</value>
        </item>
        <item>
          <key>darkwest</key>
          <value>You cannot see anything. You can feel a table in front of you.</value>
        </item>
        <item>
          <key>dimnorth</key>
          <value>There is a wall in front of you. There is a pile of toys, including an incredibly realistic anatomical skeleton to the east of you. There is a small table to the west of you.</value>
        </item>
        <item>
          <key>dimeast</key>
          <value>There is a pile of toys, including an incredibly realistic anatomical skeleton in front of you. There is a wall to the north of you. On the other side of the toys there is a glimmer in the figure of a small boy sitting. </value>
        </item>
        <item>
          <key>dimsouth</key>
          <value>There is a pile of toys, including an anatomical skeleton to the east of you, and a small table to the west of you.</value>
        </item>
        <item>
          <key>dimwest</key>
          <value>There is a table in front of you, it doesnt have anything of interest on it. There is a wall to the north of you.</value>
        </item>
        <item>
          <key>brightnorth</key>
          <value>There is a wall in front of you. There is a pile of toys, including an incredibly realistic anatomical skeleton to the east of you. There is a small table to the west of you.</value>
        </item>
        <item>
          <key>brighteast</key>
          <value>There is a pile of toys, including an incredibly realistic anatomical skeleton in front of you. There is a wall to the north of you. On the other side of the toys there is a glimmer in the figure of a small boy sitting.</value>
        </item>
        <item>
          <key>brightsouth</key>
          <value>There is a pile of toys, including an anatomical skeleton to the east of you, and a small table to the west of you.</value>
        </item>
        <item>
          <key>brightwest</key>
          <value>There is a table in front of you, it doesnt have anything of interest on it. There is a wall to the north of you.</value>
        </item>
      </descriptions>
      <description type="script">
        PrintRoomDesc (False)
      </description>
      <exit name="South136" alias="south" to="defaultroom">
        <inherit name="southdirection" />
        <runscript />
        <script type="script">
          MoveAndFace (nursery42, 2)
        </script>
      </exit>
    </object>
    <object name="nursery46">
      <inherit name="editor_room" />
      <usedefaultprefix />
      <descriptions type="stringdictionary">
        <item>
          <key>darknorth</key>
          <value>You cannot see anything.</value>
        </item>
        <item>
          <key>darkeast</key>
          <value>You cannot see anything. You can feel a wall in front of you.</value>
        </item>
        <item>
          <key>darksouth</key>
          <value>You cannot see anything.</value>
        </item>
        <item>
          <key>darkwest</key>
          <value>You cannot see anything. You can feel something in front of you.</value>
        </item>
        <item>
          <key>dimnorth</key>
          <value>You are in a narrow hallway, there is a door to the west of you, and a wall to the east.</value>
        </item>
        <item>
          <key>dimeast</key>
          <value>You are in a narrow hallway, there is a wall in front of you.</value>
        </item>
        <item>
          <key>dimsouth</key>
          <value>You are in a narrow hallway, there is a door to the west of you, and a wall to the east.</value>
        </item>
        <item>
          <key>dimwest</key>
          <value>You are in a narrow hallway, there is a door in front of you.</value>
        </item>
        <item>
          <key>brightnorth</key>
          <value>You are in a narrow hallway, there is a door to the west of you, and a wall to the east.</value>
        </item>
        <item>
          <key>brighteast</key>
          <value>You are in a narrow hallway, there is a wall in front of you.</value>
        </item>
        <item>
          <key>brightsouth</key>
          <value>You are in a narrow hallway, there is a door to the west of you, and a wall to the east.</value>
        </item>
        <item>
          <key>brightwest</key>
          <value>You are in a narrow hallway, there is a door in front of you.</value>
        </item>
      </descriptions>
      <door_closed />
      <door_locked />
      <description type="script">
        PrintRoomDesc (False)
      </description>
      <exit name="North137" alias="north" to="defaultroom">
        <inherit name="northdirection" />
        <runscript />
        <script type="script">
          MoveAndFace (nursery48, 0)
        </script>
      </exit>
      <exit name="South137" alias="south" to="defaultroom">
        <inherit name="southdirection" />
        <runscript />
        <script type="script">
          MoveAndFace (nursery44, 2)
        </script>
      </exit>
      <exit name="West136" alias="west" to="defaultroom">
        <inherit name="westdirection" />
        <runscript />
        <visible />
        <script type="script">
          if (nursery46.door_closed) {
            msg ("A closed door blocks your way.")
          }
          else {
            MoveAndFace (nursery47, 3)
            Laila.paused = True
            if (game.debug) {
              msg ("DEBUG: pause Laila")
            }
          }
        </script>
      </exit>
      <command name="Open door">
        <pattern type="string">(open|push|kick|hit|punch) door</pattern>
        <script>
          if (nursery46.door_locked) {
            msg ("You turn the handle but find the door locked.")
          }
          else {
            if (nursery46.door_closed) {
              msg ("The door swings open.")
              nursery46.door_closed = False
            }
            else {
              msg ("The door is already open.")
            }
          }
        </script>
      </command>
      <command name="Shut door">
        <pattern type="string">(close|shut|lock) door</pattern>
        <script>
          if (Peter.chasing) {
            if (nursery46.door_closed) {
              msg ("The door is already closed.")
            }
            else {
              msg ("You slam the door shut.")
              nursery46.door_closed = True
            }
          }
          else {
            if (nursery46.door_closed) {
              msg ("The door is already closed.")
            }
            else {
              nursery46.door_closed = True
              msg ("You close the door.")
            }
          }
        </script>
      </command>
    </object>
    <object name="nursery47">
      <inherit name="editor_room" />
      <usedefaultprefix />
      <descriptions type="stringdictionary">
        <item>
          <key>darknorth</key>
          <value>You cannot see anything.</value>
        </item>
        <item>
          <key>darkeast</key>
          <value>You cannot see anything. You can feel something in front of you.</value>
        </item>
        <item>
          <key>darksouth</key>
          <value>You cannot see anything. You can feel a wall in front of you.</value>
        </item>
        <item>
          <key>darkwest</key>
          <value>You cannot see anything.</value>
        </item>
        <item>
          <key>dimnorth</key>
          <value>There is a door to the east of you. To the west of you there is a translucent little boy glaring up at you. He is growling.</value>
        </item>
        <item>
          <key>dimeast</key>
          <value>There is a door in front of you. You can hear growling and grunting coming from behind you.</value>
        </item>
        <item>
          <key>dimsouth</key>
          <value>There is a wall in front of you, and a door to the east of you.  To the west there is a little boy glaring at you, snarling. </value>
        </item>
        <item>
          <key>dimwest</key>
          <value>There is a little translucent boy in front of you. He stands up off the ground and is growling, snarling, and glaring at you. He is clawing his way through the rack of old clothes to reach you.</value>
        </item>
        <item>
          <key>brightnorth</key>
          <value>There is a door to the east of you. To the west of you there is a translucent little boy glaring up at you. He is growling and looks like he is about to attack you. </value>
        </item>
        <item>
          <key>brighteast</key>
          <value>There is a door in front of you. You can hear growling and grunting coming from behind you.</value>
        </item>
        <item>
          <key>brightsouth</key>
          <value>There is a wall in front of you, and a door to the east of you.  To the west there is a little boy glaring at you, snarling. He looks like he might kill you.</value>
        </item>
        <item>
          <key>brightwest</key>
          <value>There is a little translucent boy in front of you. He stands up off the ground and is growling, snarling, and glaring at you. He is clawing his way through the rack of old clothes to reach you.</value>
        </item>
      </descriptions>
      <description type="script">
        JumpScare
        OutputTextNoBr ("As you enter the room you hear a shriek from directly in front of you. ")
        if (lantern.light_level=2) {
          msg ("There's also motion beneath a rack of hanging coats in the same direction.")
        }
        else if (lantern.light_level=1) {
          msg ("There's also motion in the same direction.")
        }
        else {
          msg ("")
        }
        Peter.chasing = True
        EnableTurnScript (peter_turn_script)
        if (game.debug) {
          msg ("DEBUG: PETER IS NOW CHASING")
        }
      </description>
      <enter type="script">
      </enter>
      <exit name="East138" alias="east" to="defaultroom">
        <inherit name="eastdirection" />
        <runscript />
        <script type="script">
          if (nursery46.door_closed) {
            msg ("A closed door blocks your way.")
          }
          else {
            MoveAndFace (nursery46, 1)
            Laila.paused = False
            if (game.debug) {
              msg ("DEBUG: unpause Laila")
            }
          }
        </script>
      </exit>
      <command name="Shut door1">
        <pattern type="string">(close|shut|lock) door</pattern>
        <script>
          if (nursery46.door_closed) {
            msg ("The door is already closed.")
          }
          else {
            nursery46.door_closed = True
            msg ("As you quickly close the door you begin to realize you've probably made a mistake.")
          }
        </script>
      </command>
      <command name="Open door1">
        <pattern type="string">(open|push|kick|hit|punch) door</pattern>
        <script>
          if (nursery46.door_closed) {
            msg ("The door swings open.")
            nursery46.door_closed = False
          }
          else {
            msg ("The door is already open.")
          }
        </script>
      </command>
      <command name="Fight Peter">
        <pattern type="string">(punch|hit|kick|fight|kill|tackle) (kid|child|peter)</pattern>
        <script>
          msg ("You try to fight the child. He wins.")
          ResetPeter
          Die
        </script>
      </command>
    </object>
    <object name="nursery48">
      <inherit name="editor_room" />
      <usedefaultprefix />
      <descriptions type="stringdictionary">
        <item>
          <key>darknorth</key>
          <value>You cannot see anything.</value>
        </item>
        <item>
          <key>darkeast</key>
          <value>You cannot see anything. You can feel a wall in front of you.</value>
        </item>
        <item>
          <key>darksouth</key>
          <value>You cannot see anything.</value>
        </item>
        <item>
          <key>darkwest</key>
          <value>You cannot see anything. You can feel a wall in front of you.</value>
        </item>
        <item>
          <key>dimnorth</key>
          <value>You are in a narrow hallway, there is a wall to the east, and to the west of you.</value>
        </item>
        <item>
          <key>dimeast</key>
          <value>You are in a narrow hallway, there is a wall in front of you.</value>
        </item>
        <item>
          <key>dimsouth</key>
          <value>You are in a narrow hallway, there is a wall to the east, and to the west of you.</value>
        </item>
        <item>
          <key>dimwest</key>
          <value>You are in a narrow hallway, there is a wall in front of you.</value>
        </item>
        <item>
          <key>brightnorth</key>
          <value>You are in a narrow hallway, there is a wall to the east, and to the west of you.</value>
        </item>
        <item>
          <key>brighteast</key>
          <value>You are in a narrow hallway, there is a wall in front of you.</value>
        </item>
        <item>
          <key>brightsouth</key>
          <value>You are in a narrow hallway, there is a wall to the east, and to the west of you.</value>
        </item>
        <item>
          <key>brightwest</key>
          <value>You are in a narrow hallway, there is a wall in front of you.</value>
        </item>
      </descriptions>
      <description type="script">
        PrintRoomDesc (False)
      </description>
      <exit name="North139" alias="north" to="defaultroom">
        <inherit name="northdirection" />
        <runscript />
        <script type="script">
          MoveAndFace (nursery49, 0)
        </script>
      </exit>
      <exit name="South139" alias="south" to="defaultroom">
        <inherit name="southdirection" />
        <runscript />
        <script type="script">
          MoveAndFace (nursery46, 2)
        </script>
      </exit>
    </object>
    <object name="nursery49">
      <inherit name="editor_room" />
      <usedefaultprefix />
      <descriptions type="stringdictionary">
        <item>
          <key>darknorth</key>
          <value>You cannot see anything.</value>
        </item>
        <item>
          <key>darkeast</key>
          <value>You cannot see anything. You can feel a wall in front of you.</value>
        </item>
        <item>
          <key>darksouth</key>
          <value>You cannot see anything.</value>
        </item>
        <item>
          <key>darkwest</key>
          <value>You cannot see anything. You can feel a wall in front of you.</value>
        </item>
        <item>
          <key>dimnorth</key>
          <value>You are in a narrow hallway, there is a wall to the east, and to the west of you.</value>
        </item>
        <item>
          <key>dimeast</key>
          <value>You are in a narrow hallway, there is a wall in front of you.</value>
        </item>
        <item>
          <key>dimsouth</key>
          <value>You are in a narrow hallway, there is a wall to the east, and to the west of you.</value>
        </item>
        <item>
          <key>dimwest</key>
          <value>You are in a narrow hallway, there is a wall in front of you.</value>
        </item>
        <item>
          <key>brightnorth</key>
          <value>You are in a narrow hallway, there is a wall to the east, and to the west of you.</value>
        </item>
        <item>
          <key>brighteast</key>
          <value>You are in a narrow hallway, there is a wall in front of you.</value>
        </item>
        <item>
          <key>brightsouth</key>
          <value>You are in a narrow hallway, there is a wall to the east, and to the west of you.</value>
        </item>
        <item>
          <key>brightwest</key>
          <value>You are in a narrow hallway, there is a wall in front of you.</value>
        </item>
      </descriptions>
      <description type="script">
        PrintRoomDesc (False)
      </description>
      <exit name="North140" alias="north" to="defaultroom">
        <inherit name="northdirection" />
        <runscript />
        <script type="script">
          MoveAndFace (nursery50, 0)
        </script>
      </exit>
      <exit name="South140" alias="south" to="defaultroom">
        <inherit name="southdirection" />
        <runscript />
        <script type="script">
          MoveAndFace (nursery48, 2)
        </script>
      </exit>
    </object>
    <object name="nursery50">
      <inherit name="editor_room" />
      <usedefaultprefix />
      <descriptions type="stringdictionary">
        <item>
          <key>darknorth</key>
          <value>You cannot see anything.</value>
        </item>
        <item>
          <key>darkeast</key>
          <value>You cannot see anything. You can feel a wall in front of you.</value>
        </item>
        <item>
          <key>darksouth</key>
          <value>You cannot see anything.</value>
        </item>
        <item>
          <key>darkwest</key>
          <value>You cannot see anything. You can feel a wall in front of you.</value>
        </item>
        <item>
          <key>dimnorth</key>
          <value>You are in a narrow hallway, there is a wall to the east, and to the west of you.</value>
        </item>
        <item>
          <key>dimeast</key>
          <value>You are in a narrow hallway, there is a wall in front of you.</value>
        </item>
        <item>
          <key>dimsouth</key>
          <value>You are in a narrow hallway, there is a wall to the east, and to the west of you.</value>
        </item>
        <item>
          <key>dimwest</key>
          <value>You are in a narrow hallway, there is a wall in front of you.</value>
        </item>
        <item>
          <key>brightnorth</key>
          <value>You are in a narrow hallway, there is a wall to the east, and to the west of you.</value>
        </item>
        <item>
          <key>brighteast</key>
          <value>You are in a narrow hallway, there is a wall in front of you.</value>
        </item>
        <item>
          <key>brightsouth</key>
          <value>You are in a narrow hallway, there is a wall to the east, and to the west of you.</value>
        </item>
        <item>
          <key>brightwest</key>
          <value>You are in a narrow hallway, there is a wall in front of you.</value>
        </item>
      </descriptions>
      <description type="script">
        PrintRoomDesc (False)
      </description>
      <exit name="North141" alias="north" to="defaultroom">
        <inherit name="northdirection" />
        <runscript />
        <script type="script">
          MoveAndFace (nursery52, 0)
        </script>
      </exit>
      <exit name="South141" alias="south" to="defaultroom">
        <inherit name="southdirection" />
        <runscript />
        <script type="script">
          MoveAndFace (nursery49, 2)
        </script>
      </exit>
    </object>
    <object name="nursery51">
      <inherit name="editor_room" />
      <usedefaultprefix />
      <descriptions type="stringdictionary">
        <item>
          <key>darknorth</key>
          <value>You cannot see anything.</value>
        </item>
        <item>
          <key>darkeast</key>
          <value>You cannot see anything. You can feel some kind of table in front of you.</value>
        </item>
        <item>
          <key>darksouth</key>
          <value>You cannot see anything. You can feel a wall in front of you.</value>
        </item>
        <item>
          <key>darkwest</key>
          <value>You cannot see anything. You can feel some kind of furniture in front of you.</value>
        </item>
        <item>
          <key>dimnorth</key>
          <value>There is a vanity table to the east of you, and a dresser to the west. </value>
        </item>
        <item>
          <key>dimeast</key>
          <value>There is a vanity table in front of you, and a wall to the south. </value>
        </item>
        <item>
          <key>dimsouth</key>
          <value>There is a wall in front of you, a vanity table to the east, and a dresser to the west. </value>
        </item>
        <item>
          <key>dimwest</key>
          <value>There is a dresser in front of you, it is dusty, old and missing one of the drawers. There is a wall to the south of you.</value>
        </item>
        <item>
          <key>brightnorth</key>
          <value>There is a vanity table to the east of you, and a dresser to the west.</value>
        </item>
        <item>
          <key>brighteast</key>
          <value>There is a vanity table in front of you, and a wall to the south. The vanity table is dusty, but looks antique and still in relatively good condition compared to the rest of the furniture youve seen.</value>
        </item>
        <item>
          <key>brightsouth</key>
          <value>There is a wall in front of you, a vanity table to the east, and a dresser to the west.</value>
        </item>
        <item>
          <key>brightwest</key>
          <value>There is a dresser in front of you, it is dusty, old and missing one of the drawers. There is a wall to the south of you.</value>
        </item>
      </descriptions>
      <description type="script">
        PrintRoomDesc (False)
      </description>
      <exit name="North142" alias="north" to="defaultroom">
        <inherit name="northdirection" />
        <runscript />
        <script type="script">
          MoveAndFace (nursery55, 0)
        </script>
      </exit>
    </object>
    <object name="nursery52">
      <inherit name="editor_room" />
      <usedefaultprefix />
      <descriptions type="stringdictionary">
        <item>
          <key>darknorth</key>
          <value>You cannot see anything.</value>
        </item>
        <item>
          <key>darkeast</key>
          <value>You cannot see anything. You can feel a wall in front of you.</value>
        </item>
        <item>
          <key>darksouth</key>
          <value>You cannot see anything.</value>
        </item>
        <item>
          <key>darkwest</key>
          <value>You cannot see anything. You can feel a wall in front of you.</value>
        </item>
        <item>
          <key>dimnorth</key>
          <value>You are in a narrow hallway, there is a wall to the east, and to the west of you.</value>
        </item>
        <item>
          <key>dimeast</key>
          <value>You are in a narrow hallway, there is a wall in front of you.</value>
        </item>
        <item>
          <key>dimsouth</key>
          <value>You are in a narrow hallway, there is a wall to the east, and to the west of you.</value>
        </item>
        <item>
          <key>dimwest</key>
          <value>You are in a narrow hallway, there is a wall in front of you.</value>
        </item>
        <item>
          <key>brightnorth</key>
          <value>You are in a narrow hallway, there is a wall to the east, and to the west of you.</value>
        </item>
        <item>
          <key>brighteast</key>
          <value>You are in a narrow hallway, there is a wall in front of you.</value>
        </item>
        <item>
          <key>brightsouth</key>
          <value>You are in a narrow hallway, there is a wall to the east, and to the west of you.</value>
        </item>
        <item>
          <key>brightwest</key>
          <value>You are in a narrow hallway, there is a wall in front of you.</value>
        </item>
      </descriptions>
      <description type="script">
        PrintRoomDesc (False)
      </description>
      <exit name="North143" alias="north" to="defaultroom">
        <inherit name="northdirection" />
        <runscript />
        <script type="script">
          MoveAndFace (nursery56, 0)
        </script>
      </exit>
      <exit name="South143" alias="south" to="defaultroom">
        <inherit name="southdirection" />
        <runscript />
        <script type="script">
          MoveAndFace (nursery50, 2)
        </script>
      </exit>
    </object>
    <object name="nursery53">
      <inherit name="editor_room" />
      <usedefaultprefix />
      <descriptions type="stringdictionary">
        <item>
          <key>darknorth</key>
          <value>You cannot see anything.</value>
        </item>
        <item>
          <key>darkeast</key>
          <value>You cannot see anything. You can feel a wall in front of you.</value>
        </item>
        <item>
          <key>darksouth</key>
          <value>You cannot see anything. You can feel a table of some sort in front of you.</value>
        </item>
        <item>
          <key>darkwest</key>
          <value>You cannot see anything. You can feel some kind of furniture in front of you, you arent completely sure what it is. </value>
        </item>
        <item>
          <key>dimnorth</key>
          <value>There is a wall to the east of you, and a chair to the west. The room is very dusty here, it is hard to breathe.</value>
        </item>
        <item>
          <key>dimeast</key>
          <value>There is a wall in front of you, and a vanity table to the south. The room is very dusty here, it is hard to breathe.</value>
        </item>
        <item>
          <key>dimsouth</key>
          <value>There is a vanity table in front of you, and a wall to the east. The vanity is old and dusty, but it is antique and in much better condition than the other furniture youve seen so far. It is very dusty here, you cough trying to breathe.</value>
        </item>
        <item>
          <key>dimwest</key>
          <value>There is an old chair in front of you, it is broken in parts, and looks like it is about to collapse. There is a vanity table to the south of you.</value>
        </item>
        <item>
          <key>brightnorth</key>
          <value>There is a wall to the east of you, and a chair to the west. The room is very dusty here, it is hard to breathe.</value>
        </item>
        <item>
          <key>brighteast</key>
          <value>There is a wall in front of you, and a vanity table to the south. The room is very dusty here, it is hard to breathe.</value>
        </item>
        <item>
          <key>brightsouth</key>
          <value>There is a vanity table in front of you, and a wall to the east. The vanity is old and dusty, but it is antique and in much better condition than the other furniture youve seen so far. It is very dusty here, you cough trying to breathe.</value>
        </item>
        <item>
          <key>brightwest</key>
          <value>There is an old chair in front of you, it is broken in parts, and looks like it is about to collapse. There is a vanity table to the south of you.</value>
        </item>
      </descriptions>
      <description type="script">
        PrintRoomDesc (False)
      </description>
      <exit name="North144" alias="north" to="defaultroom">
        <inherit name="northdirection" />
        <runscript />
        <script type="script">
          MoveAndFace (nursery57, 0)
        </script>
      </exit>
    </object>
    <object name="nursery54">
      <inherit name="editor_room" />
      <usedefaultprefix />
      <descriptions type="stringdictionary">
        <item>
          <key>darknorth</key>
          <value>You cannot see anything.</value>
        </item>
        <item>
          <key>darkeast</key>
          <value>You cannot see anything. You can feel something in front of you, but you cant quite tell what it is.</value>
        </item>
        <item>
          <key>darksouth</key>
          <value>You cannot see anything. You can feel a table of some sort in front of you.</value>
        </item>
        <item>
          <key>darkwest</key>
          <value>You cannot see anything.</value>
        </item>
        <item>
          <key>dimnorth</key>
          <value>There is an old chair to the east of you, it is broken and falling apart. There is a bed a few steps forwards.</value>
        </item>
        <item>
          <key>dimeast</key>
          <value>There is an old, falling apart chair in front of you. There is a vanity to the south of you.</value>
        </item>
        <item>
          <key>dimsouth</key>
          <value>There is a vanity table in front of you, it is old, but antique and in good condition compared to the other furniture youve seen. There is a chair to the east of you, in terrible condition.</value>
        </item>
        <item>
          <key>dimwest</key>
          <value>There is a vanity table to the south of you. A few steps forwards there is an old dresser, it is missing a drawer.</value>
        </item>
        <item>
          <key>brightnorth</key>
          <value>There is an old chair to the east of you, it is broken and falling apart. There is a bed a few steps forwards.</value>
        </item>
        <item>
          <key>brighteast</key>
          <value>There is an old, falling apart chair in front of you. There is a vanity to the south of you.</value>
        </item>
        <item>
          <key>brightsouth</key>
          <value>There is a vanity table in front of you, it is old, but antique and in good condition compared to the other furniture youve seen. There is a chair to the east of you, in terrible condition. There is a dresser a few steps west of you.</value>
        </item>
        <item>
          <key>brightwest</key>
          <value>There is a vanity table to the south of you. A few steps forwards there is an old dresser, it is missing a drawer.</value>
        </item>
      </descriptions>
      <description type="script">
        PrintRoomDesc (False)
      </description>
      <exit name="North145" alias="north" to="defaultroom">
        <inherit name="northdirection" />
        <runscript />
        <script type="script">
          MoveAndFace (nursery59, 0)
        </script>
      </exit>
      <exit name="West144" alias="west" to="defaultroom">
        <inherit name="westdirection" />
        <runscript />
        <visible />
        <script type="script">
          MoveAndFace (nursery55, 3)
        </script>
      </exit>
    </object>
    <object name="nursery55">
      <inherit name="editor_room" />
      <usedefaultprefix />
      <descriptions type="stringdictionary">
        <item>
          <key>darknorth</key>
          <value>You cannot see anything.</value>
        </item>
        <item>
          <key>darkeast</key>
          <value>You cannot see anything.</value>
        </item>
        <item>
          <key>darksouth</key>
          <value>You cannot see anything.</value>
        </item>
        <item>
          <key>darkwest</key>
          <value>You cannot see anything. You can feel some kind of piece of furniture in front of you.</value>
        </item>
        <item>
          <key>dimnorth</key>
          <value>There is an old dresser to the west of you, it is missing a drawer but there is nothing of interest in, or on it. There is a bed a few steps forwards.</value>
        </item>
        <item>
          <key>dimeast</key>
          <value>There is an old chair, which is falling apart, a few steps forwards. There is a wall a few steps south, and a bed a few steps north.</value>
        </item>
        <item>
          <key>dimsouth</key>
          <value>There is a dresser to the west of you. It is old and missing a drawer. There is a wall a few steps forwards.</value>
        </item>
        <item>
          <key>dimwest</key>
          <value>There is a dresser in front of you. It is old and missing a drawer, but there doesnt seem to be anything of interest in or on it. There is a bed a few steps north of you.</value>
        </item>
        <item>
          <key>brightnorth</key>
          <value>There is an old dresser to the west of you, it is missing a drawer but there is nothing of interest in, or on it. There is a bed a few steps forwards. </value>
        </item>
        <item>
          <key>brighteast</key>
          <value>There is an old chair, which is falling apart, a few steps forwards. There is a wall a few steps south, and a bed a few steps north.</value>
        </item>
        <item>
          <key>brightsouth</key>
          <value>There is a dresser to the west of you. It is old and missing a drawer. There is a wall a few steps forwards.</value>
        </item>
        <item>
          <key>brightwest</key>
          <value>There is a dresser in front of you. It is old and missing a drawer, but there doesnt seem to be anything of interest in or on it. There is a bed a few steps north of you.</value>
        </item>
      </descriptions>
      <description type="script">
        PrintRoomDesc (False)
      </description>
      <exit name="North146" alias="north" to="defaultroom">
        <inherit name="northdirection" />
        <runscript />
        <script type="script">
          MoveAndFace (nursery60, 0)
        </script>
      </exit>
      <exit name="East146" alias="east" to="defaultroom">
        <inherit name="eastdirection" />
        <runscript />
        <script type="script">
          MoveAndFace (nursery54, 1)
        </script>
      </exit>
      <exit name="South146" alias="south" to="defaultroom">
        <inherit name="southdirection" />
        <runscript />
        <script type="script">
          MoveAndFace (nursery51, 2)
        </script>
      </exit>
    </object>
    <object name="nursery56">
      <inherit name="editor_room" />
      <usedefaultprefix />
      <descriptions type="stringdictionary">
        <item>
          <key>darknorth</key>
          <value>You cannot see anything.</value>
        </item>
        <item>
          <key>darkeast</key>
          <value>You cannot see anything. You can feel a wall in front of you.</value>
        </item>
        <item>
          <key>darksouth</key>
          <value>You cannot see anything.</value>
        </item>
        <item>
          <key>darkwest</key>
          <value>You cannot see anything. You can feel a wall in front of you.</value>
        </item>
        <item>
          <key>dimnorth</key>
          <value>You are in a narrow hallway, there is a wall to the east, and to the west of you.</value>
        </item>
        <item>
          <key>dimeast</key>
          <value>You are in a narrow hallway, there is a wall in front of you.</value>
        </item>
        <item>
          <key>dimsouth</key>
          <value>You are in a narrow hallway, there is a wall to the east, and to the west of you.</value>
        </item>
        <item>
          <key>dimwest</key>
          <value>You are in a narrow hallway, there is a wall in front of you.</value>
        </item>
        <item>
          <key>brightnorth</key>
          <value>You are in a narrow hallway, there is a wall to the east, and to the west of you.</value>
        </item>
        <item>
          <key>brighteast</key>
          <value>You are in a narrow hallway, there is a wall in front of you.</value>
        </item>
        <item>
          <key>brightsouth</key>
          <value>You are in a narrow hallway, there is a wall to the east, and to the west of you.</value>
        </item>
        <item>
          <key>brightwest</key>
          <value>You are in a narrow hallway, there is a wall in front of you.</value>
        </item>
      </descriptions>
      <description type="script">
        PrintRoomDesc (False)
      </description>
      <exit name="North147" alias="north" to="defaultroom">
        <inherit name="northdirection" />
        <runscript />
        <script type="script">
          MoveAndFace (nursery62, 0)
        </script>
      </exit>
      <exit name="South147" alias="south" to="defaultroom">
        <inherit name="southdirection" />
        <runscript />
        <script type="script">
          MoveAndFace (nursery52, 2)
        </script>
      </exit>
    </object>
    <object name="nursery57">
      <inherit name="editor_room" />
      <usedefaultprefix />
      <descriptions type="stringdictionary">
        <item>
          <key>darknorth</key>
          <value>You cannot see anything. You can feel a small table in front of you, there seems to be something on it.</value>
        </item>
        <item>
          <key>darkeast</key>
          <value>You cannot see anything. You can feel a wall in front of you.</value>
        </item>
        <item>
          <key>darksouth</key>
          <value>You cannot see anything.</value>
        </item>
        <item>
          <key>darkwest</key>
          <value>You cannot see anything.</value>
        </item>
        <item>
          <key>dimnorth</key>
          <value>There is a small table in front of you.  There is a wall to the east of you.</value>
        </item>
        <item>
          <key>dimeast</key>
          <value>There is a wall in front of you, and a small table to the north. </value>
        </item>
        <item>
          <key>dimsouth</key>
          <value>There is a wall to the east of you. A vanity table is a few steps south of you.</value>
        </item>
        <item>
          <key>dimwest</key>
          <value>There is a small table to the north of you. There is an old, broken chair to the southwest of you.</value>
        </item>
        <item>
          <key>brightnorth</key>
          <value>There is a small table in front of you.  There is a wall to the east of you.</value>
        </item>
        <item>
          <key>brighteast</key>
          <value>There is a wall in front of you, and a small table to the north.</value>
        </item>
        <item>
          <key>brightsouth</key>
          <value>There is a wall to the east of you. A vanity table is a few steps south of you.</value>
        </item>
        <item>
          <key>brightwest</key>
          <value>There is a small table to the north of you. There is an old, broken chair to the southwest of you.</value>
        </item>
      </descriptions>
      <description type="script"><![CDATA[
        PrintRoomDesc (False)
        if (not oil6.parent = null and lantern.light_level > 0) {
          if (player.facing_num = 0) {
            msg ("There is a cask of oil sitting on the table in front of you.")
          }
          else if (player.facing_num <> 2) {
            msg ("There is a cask of oil sitting on the table to the north.")
          }
        }
      ]]></description>
      <exit name="South148" alias="south" to="defaultroom">
        <inherit name="southdirection" />
        <runscript />
        <script type="script">
          MoveAndFace (nursery53, 2)
        </script>
      </exit>
      <exit name="West147" alias="west" to="defaultroom">
        <inherit name="westdirection" />
        <runscript />
        <visible />
        <script type="script">
          MoveAndFace (nursery58, 3)
        </script>
      </exit>
      <object name="oil6">
        <inherit name="editor_object" />
        <alt type="stringlist">
          <value>cask</value>
        </alt>
        <alias>oil</alias>
        <scenery />
        <feature_usegive />
        <take type="script">
          GetOil (oil6)
        </take>
        <use type="script">
          GetOil (oil6)
        </use>
      </object>
    </object>
    <object name="nursery58">
      <inherit name="editor_room" />
      <usedefaultprefix />
      <descriptions type="stringdictionary">
        <item>
          <key>darknorth</key>
          <value>You cannot see anything.</value>
        </item>
        <item>
          <key>darkeast</key>
          <value>You cannot see anything.</value>
        </item>
        <item>
          <key>darksouth</key>
          <value>You cannot see anything. You can feel something in front of you, but you arent quite sure what it is. </value>
        </item>
        <item>
          <key>darkwest</key>
          <value>You cannot see anything.</value>
        </item>
        <item>
          <key>dimnorth</key>
          <value>There is a small table to the northeast, and a bed to the northwest.</value>
        </item>
        <item>
          <key>dimeast</key>
          <value>There is a small table to the northeast, and a broken, old chair to the south. </value>
        </item>
        <item>
          <key>dimsouth</key>
          <value>There is an old, broken chair in front of you. It is splintering, and it looks like it might collapse if anyone were to try to sit on it. There is a vanity table in front of it, with a mirror standing on it. You can see your reflection, you look different... thinner, and darker. As if you were fading away. Maybe its just the lighting.</value>
        </item>
        <item>
          <key>dimwest</key>
          <value>There is a chair to the south of you, and a bed to the northwest.</value>
        </item>
        <item>
          <key>brightnorth</key>
          <value>There is a small table it to the northeast, and a bed to the northwest.</value>
        </item>
        <item>
          <key>brighteast</key>
          <value>There is a small table to the northeast, and a broken, old chair to the south. There is a wall a few steps forwards.</value>
        </item>
        <item>
          <key>brightsouth</key>
          <value>There is an old, broken chair in front of you. It is splintering, and it looks like it might collapse if anyone were to try to sit on it. There is a vanity table in front of it, with a mirror standing on it. You can see your reflection, you look different... thinner, and darker. As if you were fading away. Maybe its just the lighting.</value>
        </item>
        <item>
          <key>brightwest</key>
          <value>There is a chair to the south of you, and a bed to the northwest.</value>
        </item>
      </descriptions>
      <description type="script"><![CDATA[
        PrintRoomDesc (False)
        if (not oil6.parent = null and lantern.light_level > 0) {
          if (player.facing_num = 0 or player.facing_num = 1) {
            msg ("There is a cask of oil sitting on the table to the northeast.")
          }
        }
      ]]></description>
      <exit name="North149" alias="north" to="defaultroom">
        <inherit name="northdirection" />
        <runscript />
        <script type="script">
          MoveAndFace (nursery63, 0)
        </script>
      </exit>
      <exit name="East149" alias="east" to="defaultroom">
        <inherit name="eastdirection" />
        <runscript />
        <script type="script">
          MoveAndFace (nursery57, 1)
        </script>
      </exit>
      <exit name="West148" alias="west" to="defaultroom">
        <inherit name="westdirection" />
        <runscript />
        <visible />
        <script type="script">
          MoveAndFace (nursery59, 3)
        </script>
      </exit>
    </object>
    <object name="nursery59">
      <inherit name="editor_room" />
      <usedefaultprefix />
      <descriptions type="stringdictionary">
        <item>
          <key>darknorth</key>
          <value>You cannot see anything. You can feel something in front of you, it feels softer and covered in a fabric.</value>
        </item>
        <item>
          <key>darkeast</key>
          <value>You cannot see anything.</value>
        </item>
        <item>
          <key>darksouth</key>
          <value>You cannot see anything.</value>
        </item>
        <item>
          <key>darkwest</key>
          <value>You cannot see anything.</value>
        </item>
        <item>
          <key>dimnorth</key>
          <value>There is a bed in front of you, there is a dusty flower patterned duvet laying on it. </value>
        </item>
        <item>
          <key>dimeast</key>
          <value>There is a bed to the north of you, and a chair to the southeast. </value>
        </item>
        <item>
          <key>dimsouth</key>
          <value>There is a chair to the southeast of you, and a vanity table a few steps forwards.</value>
        </item>
        <item>
          <key>dimwest</key>
          <value>There is a bed to the north of you, and a chair to the southeast.</value>
        </item>
        <item>
          <key>brightnorth</key>
          <value>There is a bed in front of you, there is a dusty flower patterned duvet laying on it. The flowers look like posies.</value>
        </item>
        <item>
          <key>brighteast</key>
          <value>There is a bed to the north of you, and a chair to the southeast. The bed is covered in a dusty, flower patterned duvet.</value>
        </item>
        <item>
          <key>brightsouth</key>
          <value>There is a chair to the southeast of you, and a vanity table a few steps forwards.</value>
        </item>
        <item>
          <key>brightwest</key>
          <value>There is a bed to the north of you, and a chair to the southeast. The bed is covered in a dusty, flower patterned duvet.</value>
        </item>
      </descriptions>
      <description type="script">
        PrintRoomDesc (False)
      </description>
      <exit name="East150" alias="east" to="defaultroom">
        <inherit name="eastdirection" />
        <runscript />
        <script type="script">
          MoveAndFace (nursery58, 1)
        </script>
      </exit>
      <exit name="South150" alias="south" to="defaultroom">
        <inherit name="southdirection" />
        <runscript />
        <script type="script">
          MoveAndFace (nursery54, 2)
        </script>
      </exit>
      <exit name="West149" alias="west" to="defaultroom">
        <inherit name="westdirection" />
        <runscript />
        <visible />
        <script type="script">
          MoveAndFace (nursery60, 3)
        </script>
      </exit>
    </object>
    <object name="nursery60">
      <inherit name="editor_room" />
      <usedefaultprefix />
      <descriptions type="stringdictionary">
        <item>
          <key>darknorth</key>
          <value>You cannot see anything. You can feel something in front of you, it is dusty and covered in fabric.</value>
        </item>
        <item>
          <key>darkeast</key>
          <value>You cannot see anything.</value>
        </item>
        <item>
          <key>darksouth</key>
          <value>You cannot see anything.</value>
        </item>
        <item>
          <key>darkwest</key>
          <value>You cannot see anything.</value>
        </item>
        <item>
          <key>dimnorth</key>
          <value>There is a bed in front of you, it has a dusty, flower patterned duvet laying on it.</value>
        </item>
        <item>
          <key>dimeast</key>
          <value>There is a bed to the north of you. It has a dusty, flower patterned duvet laying on it.</value>
        </item>
        <item>
          <key>dimsouth</key>
          <value>There is an old dresser to the southwest of you</value>
        </item>
        <item>
          <key>dimwest</key>
          <value>There is a bed to the north of you, there is a flower patterned duvet laying on it. There is a wall a few steps forwards, and a dresser to the southwest.</value>
        </item>
        <item>
          <key>brightnorth</key>
          <value>There is a bed in front of you, it has a dusty, flower patterned duvet laying on it. The flowers look like posies.</value>
        </item>
        <item>
          <key>brighteast</key>
          <value>There is a bed to the north of you. It has a dusty, flower patterned duvet laying on it. The flowers look like posies.</value>
        </item>
        <item>
          <key>brightsouth</key>
          <value>There is an old dresser to the southwest of you, and a vanity table a few steps southeast.</value>
        </item>
        <item>
          <key>brightwest</key>
          <value>There is a bed to the north of you, there is a flower patterned duvet laying on it. There is a wall a few steps forwards, and a dresser to the southwest. The flowers look like posies.</value>
        </item>
      </descriptions>
      <description type="script">
        PrintRoomDesc (False)
      </description>
      <exit name="East151" alias="east" to="defaultroom">
        <inherit name="eastdirection" />
        <runscript />
        <script type="script">
          MoveAndFace (nursery59, 1)
        </script>
      </exit>
      <exit name="South151" alias="south" to="defaultroom">
        <inherit name="southdirection" />
        <runscript />
        <script type="script">
          MoveAndFace (nursery55, 2)
        </script>
      </exit>
      <exit name="West150" alias="west" to="defaultroom">
        <inherit name="westdirection" />
        <runscript />
        <visible />
        <script type="script">
          MoveAndFace (nursery61, 3)
        </script>
      </exit>
    </object>
    <object name="nursery61">
      <inherit name="editor_room" />
      <usedefaultprefix />
      <descriptions type="stringdictionary">
        <item>
          <key>darknorth</key>
          <value>You cannot see anything. You can feel something covered in a dusty fabric in front of you.</value>
        </item>
        <item>
          <key>darkeast</key>
          <value>You cannot see anything.</value>
        </item>
        <item>
          <key>darksouth</key>
          <value>You cannot see anything. You can feel a hard surface in front of you.</value>
        </item>
        <item>
          <key>darkwest</key>
          <value>You cannot see anything. You can feel a wall in front of you.</value>
        </item>
        <item>
          <key>dimnorth</key>
          <value>There is a bed in front of you, it has a flower patterned duvet on it. The flowers look like posies. There is a wall to the west of you.</value>
        </item>
        <item>
          <key>dimeast</key>
          <value>There is a bed to the north of you, covered in a flower patterned duvet. The flowers look like posies. There is a dresser to the south of you.</value>
        </item>
        <item>
          <key>dimsouth</key>
          <value>There is a dresser in front of you, it is old and broken but there is nothing of interest in or on it. There is a wall to the west of you.</value>
        </item>
        <item>
          <key>dimwest</key>
          <value>There is a wall in front of you. There is an old dresser to the south of you, and a bed to the north. The bed has a flower patterned duvet on it, the flowers look like posies.</value>
        </item>
        <item>
          <key>brightnorth</key>
          <value>There is a bed in front of you, it has a flower patterned duvet on it. The flowers look like posies. There is a wall to the west of you.</value>
        </item>
        <item>
          <key>brighteast</key>
          <value>There is a bed to the north of you, covered in a flower patterned duvet. The flowers look like posies. There is a dresser to the south of you.</value>
        </item>
        <item>
          <key>brightsouth</key>
          <value>There is a dresser in front of you, it is old and broken but there is nothing of interest in or on it. There is a wall to the west of you.</value>
        </item>
        <item>
          <key>brightwest</key>
          <value>There is a wall in front of you. There is an old dresser to the south of you, and a bed to the north. The bed has a flower patterned duvet on it, the flowers look like posies.</value>
        </item>
        <item>
          <key>notes</key>
          <value>This is where the boy hides for the 2nd time.</value>
        </item>
      </descriptions>
      <attr name="maven_here" type="boolean">false</attr>
      <description type="script"><![CDATA[
        PrintRoomDesc (False)
        if (nursery61.maven_here and player.facing_num = 0) {
          if (Maven.conversation_part = 4 and lantern.light_level <> 0) {
            msg ("You can see a faint glow emanating from under the bed.")
          }
          else if (Maven.conversation_part = 5) {
            msg ("Maven is standing in front of you.")
          }
        }
      ]]></description>
      <exit name="East152" alias="east" to="defaultroom">
        <inherit name="eastdirection" />
        <runscript />
        <script type="script">
          MoveAndFace (nursery60, 1)
        </script>
      </exit>
      <command name="Examine Bed">
        <pattern type="string">(examine|look|check|ex|x|l|look in|open) bed</pattern>
        <script>
          if (nursery61.maven_here) {
            DisableHeart
            if (Maven.conversation_part = 4) {
              msg ("Yay! Youre so good at this! Maven bounces around you, excitedly. He stops and looks at you for a moment, then says You know youre changing, right? Like, you feel different, right?' You look at him confused for a moment. 'Ah, never mind, I guess its better if you dont know.' Maven nods to himself, and spins around in a circle. 'Can we play one last time? Ill help you get out of here if you do'")
              Maven.conversation_part = 5
            }
            else if (Maven.conversation_part = 5) {
              msg ("'So will you play again?' he asks, looking much happier than when you originally met him.")
            }
          }
          else {
            msg ("There's nothing particularly interesting about the bed.")
          }
        </script>
      </command>
      <command name="Talk To Maven1">
        <unresolved type="string"></unresolved>
        <pattern type="string">(talk|talk to|talk to boy|talk to ghost|speak|speak to|speak to boy|speak to ghost)</pattern>
        <script>
          if (nursery61.maven_here and Maven.conversation_part = 5) {
            DisableHeart
            msg ("'So will you play again?' he asks, looking much happier than when you originally met him.")
          }
          else {
            msg ("I don't understand your command.")
          }
        </script>
      </command>
      <command name="Say Yes4">
        <pattern type="string">(say yes|yes|tell boy yes|tell ghost yes|accept|accept game|play|play with boy|play with ghost)</pattern>
        <script>
          if (Maven.conversation_part = 5) {
            DisableHeart
            msg ("Maven, already excited, bounces away without even replying. You can hear him singing again though: 'Hush-a-by baby, On the tree top, When the wind blows, The cradle will rock...'")
            nursery61.maven_here = False
            nursery25.maven_here = True
            Maven.conversation_part = 6
          }
          else {
            msg ("I don't understand your command.")
          }
        </script>
      </command>
    </object>
    <object name="nursery62">
      <inherit name="editor_room" />
      <usedefaultprefix />
      <descriptions type="stringdictionary">
        <item>
          <key>darknorth</key>
          <value>You cannot see anything.</value>
        </item>
        <item>
          <key>darkeast</key>
          <value>You cannot see anything. You can feel a wall in front of you.</value>
        </item>
        <item>
          <key>darksouth</key>
          <value>You cannot see anything.</value>
        </item>
        <item>
          <key>darkwest</key>
          <value>You cannot see anything. You can feel a wall in front of you.</value>
        </item>
        <item>
          <key>dimnorth</key>
          <value>You are in a narrow hallway, there is a wall to the east, and to the west of you.</value>
        </item>
        <item>
          <key>dimeast</key>
          <value>You are in a narrow hallway, there is a wall in front of you.</value>
        </item>
        <item>
          <key>dimsouth</key>
          <value>You are in a narrow hallway, there is a wall to the east, and to the west of you.</value>
        </item>
        <item>
          <key>dimwest</key>
          <value>You are in a narrow hallway, there is a wall in front of you.</value>
        </item>
        <item>
          <key>brightnorth</key>
          <value>You are in a narrow hallway, there is a wall to the east, and to the west of you.</value>
        </item>
        <item>
          <key>brighteast</key>
          <value>You are in a narrow hallway, there is a wall in front of you.</value>
        </item>
        <item>
          <key>brightsouth</key>
          <value>You are in a narrow hallway, there is a wall to the east, and to the west of you.</value>
        </item>
        <item>
          <key>brightwest</key>
          <value>You are in a narrow hallway, there is a wall in front of you.</value>
        </item>
      </descriptions>
      <description type="script">
        PrintRoomDesc (False)
      </description>
      <exit name="North153" alias="north" to="defaultroom">
        <inherit name="northdirection" />
        <runscript />
        <script type="script">
          MoveAndFace (nursery64, 0)
        </script>
      </exit>
      <exit name="South153" alias="south" to="defaultroom">
        <inherit name="southdirection" />
        <runscript />
        <script type="script">
          MoveAndFace (nursery56, 2)
        </script>
      </exit>
    </object>
    <object name="nursery63">
      <inherit name="editor_room" />
      <usedefaultprefix />
      <descriptions type="stringdictionary">
        <item>
          <key>darknorth</key>
          <value>You cannot see anything.</value>
        </item>
        <item>
          <key>darkeast</key>
          <value>You cannot see anything. You can feel a small table in front of you.</value>
        </item>
        <item>
          <key>darksouth</key>
          <value>You cannot see anything.</value>
        </item>
        <item>
          <key>darkwest</key>
          <value>You cannot see anything. You can feel something in front of you, it is covered in fabric.</value>
        </item>
        <item>
          <key>dimnorth</key>
          <value>There is a small table to the east of you. There is a bed to the west of you, it has a flower patterned duvet on it.</value>
        </item>
        <item>
          <key>dimeast</key>
          <value>There is a small table in front of you. </value>
        </item>
        <item>
          <key>dimsouth</key>
          <value>There is a small table to the east, and a bed to the west. The bed has a flower patterned duvet on it.</value>
        </item>
        <item>
          <key>dimwest</key>
          <value>There is a bed in front of you, it has a flower patterned duvet on it. </value>
        </item>
        <item>
          <key>brightnorth</key>
          <value>There is a small table to the east of you. There is a bed to the west of you, it has a flower patterned duvet on it. There is a wall a few spaces forwards.</value>
        </item>
        <item>
          <key>brighteast</key>
          <value>There is a small table in front of you.</value>
        </item>
        <item>
          <key>brightsouth</key>
          <value>There is a small table to the east, and a bed to the west. The bed has a flower patterned duvet on it. There is an old chair a few steps forwards.</value>
        </item>
        <item>
          <key>brightwest</key>
          <value>There is a bed in front of you, it has a flower patterned duvet on it. The flowers look like posies. There is a wall a few steps north of you. </value>
        </item>
      </descriptions>
      <description type="script"><![CDATA[
        PrintRoomDesc (False)
        if (not oil6.parent = null and lantern.light_level > 0) {
          if (player.facing_num = 1) {
            msg ("There is a cask of oil sitting on the table in front of you.")
          }
          else if (player.facing_num <> 3) {
            msg ("There is a cask of oil sitting on the table to the east.")
          }
        }
      ]]></description>
      <exit name="North154" alias="north" to="defaultroom">
        <inherit name="northdirection" />
        <runscript />
        <script type="script">
          MoveAndFace (nursery66, 0)
        </script>
      </exit>
      <exit name="South154" alias="south" to="defaultroom">
        <inherit name="southdirection" />
        <runscript />
        <script type="script">
          MoveAndFace (nursery58, 2)
        </script>
      </exit>
    </object>
    <object name="nursery64">
      <inherit name="editor_room" />
      <usedefaultprefix />
      <descriptions type="stringdictionary">
        <item>
          <key>darknorth</key>
          <value>You cannot see anything. You can feel a wall in front of you.</value>
        </item>
        <item>
          <key>darkeast</key>
          <value>You cannot see anything. You can feel a wall in front of you.</value>
        </item>
        <item>
          <key>darksouth</key>
          <value>You cannot see anything.</value>
        </item>
        <item>
          <key>darkwest</key>
          <value>You cannot see anything. You can feel something in front of you.</value>
        </item>
        <item>
          <key>dimnorth</key>
          <value>You are in a narrow hallway, there is a wall in front of you, and a door to the west.</value>
        </item>
        <item>
          <key>dimeast</key>
          <value>You are in a narrow hallway, there is a wall in front of you.</value>
        </item>
        <item>
          <key>dimsouth</key>
          <value>You are in a narrow hallway, there is a door to the west of you, and a wall to the east.</value>
        </item>
        <item>
          <key>dimwest</key>
          <value>You are in a narrow hallway, there is a door in front of you, and a wall to the north of you.</value>
        </item>
        <item>
          <key>brightnorth</key>
          <value>You are in a narrow hallway, there is a wall in front of you, and a door to the west.</value>
        </item>
        <item>
          <key>brighteast</key>
          <value>You are in a narrow hallway, there is a wall in front of you.</value>
        </item>
        <item>
          <key>brightsouth</key>
          <value>You are in a narrow hallway, there is a door to the west of you, and a wall to the east.</value>
        </item>
        <item>
          <key>brightwest</key>
          <value>You are in a narrow hallway, there is a door in front of you, and a wall to the north of you.</value>
        </item>
      </descriptions>
      <door_locked />
      <door_closed />
      <description type="script">
        PrintRoomDesc (False)
      </description>
      <exit name="South155" alias="south" to="defaultroom">
        <inherit name="southdirection" />
        <runscript />
        <script type="script">
          MoveAndFace (nursery62, 2)
        </script>
      </exit>
      <exit name="West154" alias="west" to="defaultroom">
        <inherit name="westdirection" />
        <runscript />
        <visible />
        <script type="script">
          if (nursery64.door_closed) {
            msg ("A closed door blocks your way.")
          }
          else {
            MoveAndFace (nursery65, 3)
            Laila.paused = True
            if (game.debug) {
              msg ("DEBUG: pause Laila")
            }
          }
        </script>
      </exit>
      <command name="Open door10">
        <pattern type="string">(open|push|kick|hit|punch) door</pattern>
        <script>
          if (nursery64.door_locked) {
            msg ("You turn the handle but find the door locked.")
          }
          else {
            if (nursery64.door_closed) {
              msg ("The door swings open.")
              nursery64.door_closed = False
            }
            else {
              msg ("The door is already open.")
            }
          }
        </script>
      </command>
      <command name="Shut door10">
        <pattern type="string">(close|shut) door</pattern>
        <script>
          if (nursery64.door_closed) {
            msg ("The door is already closed.")
          }
          else {
            nursery64.door_closed = True
            msg ("You close the door.")
          }
        </script>
      </command>
    </object>
    <object name="nursery65">
      <inherit name="editor_room" />
      <usedefaultprefix />
      <descriptions type="stringdictionary">
        <item>
          <key>darknorth</key>
          <value>You cannot see anything. You can feel a wall in front of you.</value>
        </item>
        <item>
          <key>darkeast</key>
          <value>You cannot see anything. You can feel something in front of you.</value>
        </item>
        <item>
          <key>darksouth</key>
          <value>You cannot see anything. You can feel a table in front of you.</value>
        </item>
        <item>
          <key>darkwest</key>
          <value>You cannot see anything.</value>
        </item>
        <item>
          <key>dimnorth</key>
          <value>There is a wall in front of you, and a door to the east of you. </value>
        </item>
        <item>
          <key>dimeast</key>
          <value>There is a door in front of you, and a small table to the south. There is a wall to the north of you.</value>
        </item>
        <item>
          <key>dimsouth</key>
          <value>There is a small table in front of you. There is a door to the east of you.</value>
        </item>
        <item>
          <key>dimwest</key>
          <value>There is a small table to the south of you. There is a wall to the north.</value>
        </item>
        <item>
          <key>brightnorth</key>
          <value>There is a wall in front of you, and a door to the east of you. There is a bed a few steps west of you.</value>
        </item>
        <item>
          <key>brighteast</key>
          <value>There is a door in front of you, and a small table to the south. There is a wall to the north of you.</value>
        </item>
        <item>
          <key>brightsouth</key>
          <value>There is a small table in front of you. There is a door to the east of you, and there is a bed a few steps to the west of you.</value>
        </item>
        <item>
          <key>brightwest</key>
          <value>There is a small table to the south of you. There is a wall to the north, and a bed a few steps forwards.</value>
        </item>
      </descriptions>
      <description type="script"><![CDATA[
        PrintRoomDesc (False)
        if (not oil6.parent = null and lantern.light_level > 0) {
          if (player.facing_num = 2) {
            msg ("There is a cask of oil sitting on the table in front of you.")
          }
          else if (player.facing_num <> 0) {
            msg ("There is a cask of oil sitting on the table to the south.")
          }
        }
      ]]></description>
      <exit name="East156" alias="east" to="defaultroom">
        <inherit name="eastdirection" />
        <runscript />
        <script type="script">
          if (nursery64.door_closed) {
            msg ("A closed door blocks your way.")
          }
          else {
            MoveAndFace (nursery64, 1)
            Laila.paused = False
            if (game.debug) {
              msg ("DEBUG: unpause Laila")
            }
          }
        </script>
      </exit>
      <exit name="West155" alias="west" to="defaultroom">
        <inherit name="westdirection" />
        <runscript />
        <visible />
        <script type="script">
          MoveAndFace (nursery66, 3)
        </script>
      </exit>
      <command name="Open door11">
        <pattern type="string">(open|push|kick|hit|punch) door</pattern>
        <script>
          if (nursery64.door_closed) {
            msg ("The door swings open.")
            nursery64.door_closed = False
          }
          else {
            msg ("The door is already open.")
          }
        </script>
      </command>
      <command name="Shut door11">
        <pattern type="string">(close|shut) door</pattern>
        <script>
          if (nursery64.door_closed) {
            msg ("The door is already closed.")
          }
          else {
            nursery64.door_closed = True
            msg ("You close the door.")
          }
        </script>
      </command>
    </object>
    <object name="nursery66">
      <inherit name="editor_room" />
      <usedefaultprefix />
      <descriptions type="stringdictionary">
        <item>
          <key>darknorth</key>
          <value>You cannot see anything. You can feel a wall in front of you.</value>
        </item>
        <item>
          <key>darkeast</key>
          <value>You cannot see anything.</value>
        </item>
        <item>
          <key>darksouth</key>
          <value>You cannot see anything.</value>
        </item>
        <item>
          <key>darkwest</key>
          <value>You cannot see anything. You can feel something covered in a dusty fabric in front of you.</value>
        </item>
        <item>
          <key>dimnorth</key>
          <value>There is a wall in front of you, and a bed to the west of you. The bed has a flower patterned duvet covering it.</value>
        </item>
        <item>
          <key>dimeast</key>
          <value>There is a wall to the north of you, and a small table to the southeast.</value>
        </item>
        <item>
          <key>dimsouth</key>
          <value>There is a bed to the west of you, it is covered in a flower patterned duvet. There is a small table to the southeast.</value>
        </item>
        <item>
          <key>dimwest</key>
          <value>There is a bed in front of you, it is covered in a flower patterned duvet. There is a wall to the north of you.</value>
        </item>
        <item>
          <key>brightnorth</key>
          <value>There is a wall in front of you, and a bed to the west of you. The bed has a flower patterned duvet covering it. The flowers look like posies.</value>
        </item>
        <item>
          <key>brighteast</key>
          <value>There is a wall to the north of you, and a small table to the southeast. There is a door a few steps forwards.</value>
        </item>
        <item>
          <key>brightsouth</key>
          <value>There is a bed to the west of you, it is covered in a flower patterned duvet. The flowers look like posies. There is a small table to the southeast. </value>
        </item>
        <item>
          <key>brightwest</key>
          <value>There is a bed in front of you, it is covered in a flower patterned duvet. The flowers look like posies. There is a wall to the north of you. </value>
        </item>
      </descriptions>
      <description type="script"><![CDATA[
        PrintRoomDesc (False)
        if (not oil6.parent = null and lantern.light_level > 0) {
          if (player.facing_num = 2 or player.facing_num = 1) {
            msg ("There is a cask of oil sitting on the table to the southeast.")
          }
        }
      ]]></description>
      <exit name="East157" alias="east" to="defaultroom">
        <inherit name="eastdirection" />
        <runscript />
        <script type="script">
          MoveAndFace (nursery65, 1)
        </script>
      </exit>
      <exit name="South157" alias="south" to="defaultroom">
        <inherit name="southdirection" />
        <runscript />
        <script type="script">
          MoveAndFace (nursery63, 2)
        </script>
      </exit>
    </object>
    <object name="Peter">
      <inherit name="editor_object" />
      <chasing type="boolean">false</chasing>
      <distance type="int">3</distance>
      <attr name="start_distance" type="int">3</attr>
    </object>
    <object name="Laila">
      <inherit name="editor_object" />
      <attr name="chase_state" type="int">0</attr>
      <paused />
      <attr name="sub_state" type="int">0</attr>
      <attr name="attack_from" type="int">0</attr>
    </object>
    <object name="Maven">
      <inherit name="editor_object" />
      <attr name="conversation_part" type="int">0</attr>
    </object>
  </object>
  <object name="library">
    <inherit name="editor_object" />
    <attr name="grumpy_shadow_counter" type="int">0</attr>
    <darknessTimer type="int">0</darknessTimer>
    <fireCount type="int">0</fireCount>
    <object name="library1">
      <inherit name="editor_room" />
      <usedefaultprefix />
      <descriptions type="stringdictionary">
        <item>
          <key>darknorth</key>
          <value>You cannot see anything. You feel as if you have faded into the darkness. You can feel a wall in front of you.</value>
        </item>
        <item>
          <key>darkeast</key>
          <value>You cannot see anything. You feel as if you have faded into the darkness.</value>
        </item>
        <item>
          <key>darksouth</key>
          <value>You cannot see anything. You feel as if you have faded into the darkness. You can feel a wall in front of you.</value>
        </item>
        <item>
          <key>darkwest</key>
          <value>You cannot see anything. You feel as if you have faded into the darkness. You can feel a hard surface in front of you.</value>
        </item>
        <item>
          <key>dimnorth</key>
          <value>There is a wall in front of you, and a locked door to the west.</value>
        </item>
        <item>
          <key>dimeast</key>
          <value>There is a wall to the south and north of you.</value>
        </item>
        <item>
          <key>dimsouth</key>
          <value>There is a wall in front of you, and a door to the west. The door is locked.</value>
        </item>
        <item>
          <key>dimwest</key>
          <value>There is a door in front of you, it is locked. There is a wall to the north, and the south of you.</value>
        </item>
        <item>
          <key>brightnorth</key>
          <value>There is a wall in front of you, and a locked door to the west. </value>
        </item>
        <item>
          <key>brighteast</key>
          <value>There is a wall to the south and north of you.</value>
        </item>
        <item>
          <key>brightsouth</key>
          <value>There is a wall in front of you, and a door to the west. The door is locked.</value>
        </item>
        <item>
          <key>brightwest</key>
          <value>There is a door in front of you, it is locked. There is a wall to the north, and the south of you.</value>
        </item>
      </descriptions>
      <description type="script">
        PrintRoomDesc (False)
      </description>
      <beforeenter type="script">
        library_turn_script.enabled = true
      </beforeenter>
      <exit name="East59" alias="east" to="defaultroom">
        <inherit name="eastdirection" />
        <runscript />
        <script type="script">
          MoveAndFace (library2, 1)
        </script>
      </exit>
      <exit name="West60" alias="west" to="defaultroom">
        <inherit name="westdirection" />
        <runscript />
        <visible />
        <script type="script">
          MoveAndFace (hub14, 3)
        </script>
      </exit>
    </object>
    <object name="library2">
      <inherit name="editor_room" />
      <usedefaultprefix />
      <descriptions type="stringdictionary">
        <item>
          <key>darknorth</key>
          <value>You cannot see anything. You feel as if you have faded into the darkness. You can feel a wall in front of you.</value>
        </item>
        <item>
          <key>darkeast</key>
          <value>You cannot see anything. You feel as if you have faded into the darkness.</value>
        </item>
        <item>
          <key>darksouth</key>
          <value>You cannot see anything. You feel as if you have faded into the darkness. You can feel a wall in front of you.</value>
        </item>
        <item>
          <key>darkwest</key>
          <value>You cannot see anything. You feel as if you have faded into the darkness.</value>
        </item>
        <item>
          <key>dimnorth</key>
          <value>There is a wall in front of you.</value>
        </item>
        <item>
          <key>dimeast</key>
          <value>There is a wall to the south, and north of you. </value>
        </item>
        <item>
          <key>dimsouth</key>
          <value>There is a wall in front of you.</value>
        </item>
        <item>
          <key>dimwest</key>
          <value>There is a wall to the south and north of you.</value>
        </item>
        <item>
          <key>brightnorth</key>
          <value>There is a wall in front of you. A few steps west is a dead end, and a locked door.</value>
        </item>
        <item>
          <key>brighteast</key>
          <value>There is a wall to the south, and north of you. There is a wall in front of you, a few steps forwards.</value>
        </item>
        <item>
          <key>brightsouth</key>
          <value>There is a wall in front of you. The wall is dirty, and covered in wallpaper that is peeling and yellowed.</value>
        </item>
        <item>
          <key>brightwest</key>
          <value>There is a wall to the south and north of you. There is a door a step forwards, it is the one you came in from.</value>
        </item>
      </descriptions>
      <description type="script">
        PrintRoomDesc (False)
      </description>
      <exit name="West61" alias="west" to="defaultroom">
        <inherit name="westdirection" />
        <runscript />
        <visible />
        <script type="script">
          MoveAndFace (library1, 3)
        </script>
      </exit>
      <exit name="East60" alias="east" to="defaultroom">
        <inherit name="eastdirection" />
        <runscript />
        <script type="script">
          MoveAndFace (library9, 1)
        </script>
      </exit>
    </object>
    <object name="library3">
      <inherit name="editor_room" />
      <usedefaultprefix />
      <descriptions type="stringdictionary">
        <item>
          <key>darknorth</key>
          <value>You cannot see anything. You feel as if you have faded into the darkness. </value>
        </item>
        <item>
          <key>darkeast</key>
          <value>You cannot see anything. You feel as if you have faded into the darkness. You can feel a bookshelf in front of you.</value>
        </item>
        <item>
          <key>darksouth</key>
          <value>You cannot see anything. You feel as if you have faded into the darkness. You can feel a wall in front of you.</value>
        </item>
        <item>
          <key>darkwest</key>
          <value>You cannot see anything. You feel as if you have faded into the darkness. You can feel a wall in front of you.</value>
        </item>
        <item>
          <key>dimnorth</key>
          <value>There is a wall to the west of you, and a shelf filled with books to the east. </value>
        </item>
        <item>
          <key>dimeast</key>
          <value>There is a bookshelf in front of you. </value>
        </item>
        <item>
          <key>dimsouth</key>
          <value>There is a wall in front of you.</value>
        </item>
        <item>
          <key>dimwest</key>
          <value>There is a wall in front of you, and a wall to the south of you.</value>
        </item>
        <item>
          <key>brightnorth</key>
          <value>There is a wall to the west of you, and a shelf filled with books to the east.</value>
        </item>
        <item>
          <key>brighteast</key>
          <value>There is a bookshelf in front of you.</value>
        </item>
        <item>
          <key>brightsouth</key>
          <value>There is a wall in front of you. The hallway you are in leads to the north, and ends to the south. </value>
        </item>
        <item>
          <key>brightwest</key>
          <value>There is a wall in front of you, and a wall to the south of you. The hallway continues to the north. </value>
        </item>
      </descriptions>
      <description type="script">
        PrintRoomDesc (False)
      </description>
      <exit name="North69" alias="north" to="defaultroom">
        <inherit name="northdirection" />
        <runscript />
        <script type="script">
          MoveAndFace (library4, 0)
        </script>
      </exit>
    </object>
    <object name="library4">
      <inherit name="editor_room" />
      <usedefaultprefix />
      <descriptions type="stringdictionary">
        <item>
          <key>darknorth</key>
          <value>You cannot see anything. You feel as if you have faded into the darkness. </value>
        </item>
        <item>
          <key>darkeast</key>
          <value>You cannot see anything. You feel as if you have faded into the darkness. You can feel a bookshelf in front of you.</value>
        </item>
        <item>
          <key>darksouth</key>
          <value>You cannot see anything. You feel as if you have faded into the darkness. </value>
        </item>
        <item>
          <key>darkwest</key>
          <value>You cannot see anything. You feel as if you have faded into the darkness. You can feel a wall in front of you.</value>
        </item>
        <item>
          <key>dimnorth</key>
          <value>There is a wall to the west, and a bookshelf to the east.</value>
        </item>
        <item>
          <key>dimeast</key>
          <value>There is a bookshelf in front of you. The hallway continues to the south, and north. </value>
        </item>
        <item>
          <key>dimsouth</key>
          <value>There is a bookshelf to the east of you, and a wall to the west.</value>
        </item>
        <item>
          <key>dimwest</key>
          <value>There is a wall in front of you.</value>
        </item>
        <item>
          <key>brightnorth</key>
          <value>There is a wall to the west, and a bookshelf to the east. The hallway continues to the north.</value>
        </item>
        <item>
          <key>brighteast</key>
          <value>There is a bookshelf in front of you. The hallway continues to the south, and north. The southern path seems to have a dead end.</value>
        </item>
        <item>
          <key>brightsouth</key>
          <value>There is a bookshelf to the east of you, and a wall to the west. There is a dead end up ahead. </value>
        </item>
        <item>
          <key>brightwest</key>
          <value>There is a wall in front of you. The path continues to the south and north. The southern path seems to have a dead end a few steps away. </value>
        </item>
        <item>
          <key>notes</key>
          <value>TRAP SPACE. The first time you walk on this space only. </value>
        </item>
      </descriptions>
      <description type="script">
        PrintRoomDesc (False)
      </description>
      <beforefirstenter type="script">
        msg ("You trip on a book lying on the floor, falling into the shelf. While trying to catch yourself you flail your arms for balance. Your lantern is blown out from the air movement, and you regain your balance, standing upright again.")
        lantern.light_level = 0
        JumpScare
      </beforefirstenter>
      <exit name="South52" alias="south" to="defaultroom">
        <inherit name="southdirection" />
        <runscript />
        <script type="script">
          MoveAndFace (library3, 2)
        </script>
      </exit>
      <exit name="North79" alias="north" to="defaultroom">
        <inherit name="northdirection" />
        <runscript />
        <script type="script">
          MoveAndFace (library5, 0)
        </script>
      </exit>
    </object>
    <object name="library5">
      <inherit name="editor_room" />
      <usedefaultprefix />
      <descriptions type="stringdictionary">
        <item>
          <key>darknorth</key>
          <value>You cannot see anything. You feel as if you have faded into the darkness. </value>
        </item>
        <item>
          <key>darkeast</key>
          <value>You cannot see anything. You feel as if you have faded into the darkness. You can feel a bookshelf in front of you.</value>
        </item>
        <item>
          <key>darksouth</key>
          <value>You cannot see anything. You feel as if you have faded into the darkness.</value>
        </item>
        <item>
          <key>darkwest</key>
          <value>You cannot see anything. You feel as if you have faded into the darkness. You can feel a wall in front of you.</value>
        </item>
        <item>
          <key>dimnorth</key>
          <value>There is a bookshelf to the east, and a wall to the west. </value>
        </item>
        <item>
          <key>dimeast</key>
          <value>There is a bookshelf in front of you. The path you are on continues to the south, and north.</value>
        </item>
        <item>
          <key>dimsouth</key>
          <value>There is a bookshelf to the east, and a wall to the west. </value>
        </item>
        <item>
          <key>dimwest</key>
          <value>There is a wall in front of you, the path continues to the south, and the north.</value>
        </item>
        <item>
          <key>brightnorth</key>
          <value>There is a bookshelf to the east, and a wall to the west. The path turns a step forwards.</value>
        </item>
        <item>
          <key>brighteast</key>
          <value>There is a bookshelf in front of you. The path you are on continues to the south, and north. The path to the north seems to turn a step to the north.</value>
        </item>
        <item>
          <key>brightsouth</key>
          <value>There is a bookshelf to the east, and a wall to the west. The path continues forwards.</value>
        </item>
        <item>
          <key>brightwest</key>
          <value>There is a wall in front of you, the path continues to the south, and the north. </value>
        </item>
      </descriptions>
      <description type="script">
        PrintRoomDesc (False)
      </description>
      <exit name="South56" alias="south" to="defaultroom">
        <inherit name="southdirection" />
        <runscript />
        <script type="script">
          MoveAndFace (library4, 2)
        </script>
      </exit>
      <exit name="North81" alias="north" to="defaultroom">
        <inherit name="northdirection" />
        <runscript />
        <script type="script">
          MoveAndFace (library6, 0)
        </script>
      </exit>
    </object>
    <object name="library6">
      <inherit name="editor_room" />
      <usedefaultprefix />
      <descriptions type="stringdictionary">
        <item>
          <key>darknorth</key>
          <value>You cannot see anything. You feel as if you have faded into the darkness. You can feel a bookshelf in front of you.</value>
        </item>
        <item>
          <key>darkeast</key>
          <value>You cannot see anything. You feel as if you have faded into the darkness.</value>
        </item>
        <item>
          <key>darksouth</key>
          <value>You cannot see anything. You feel as if you have faded into the darkness.</value>
        </item>
        <item>
          <key>darkwest</key>
          <value>You cannot see anything. You feel as if you have faded into the darkness. You can feel a wall in front of you.</value>
        </item>
        <item>
          <key>dimnorth</key>
          <value>There is a bookshelf in front of you, and a wall to the west. There is a red book on the shelf, with gold lettering scrawled on the spine.</value>
        </item>
        <item>
          <key>dimeast</key>
          <value>There is a bookshelf to the north of you, there is a book in the shelf that catches your eye. It is red, with gold lettering.</value>
        </item>
        <item>
          <key>dimsouth</key>
          <value>There is a wall to the west of you. The path continues forwards.</value>
        </item>
        <item>
          <key>dimwest</key>
          <value>There is a wall in front of you, and a bookshelf to the north. There is a red book on the shelf, with gold lettering.</value>
        </item>
        <item>
          <key>brightnorth</key>
          <value>There is a bookshelf in front of you, and a wall to the west. The path turns to the east.  There is a red book on the shelf, with gold lettering on the spine. It says The Kings Court on it.</value>
        </item>
        <item>
          <key>brighteast</key>
          <value>There is a bookshelf to the north of you, there is a book in the shelf that catches your eye. It is red, with gold lettering. It says The Kings Court on it. </value>
        </item>
        <item>
          <key>brightsouth</key>
          <value>There is a wall to the west of you. The path continues forwards, and also goes to the east of you. </value>
        </item>
        <item>
          <key>brightwest</key>
          <value>There is a wall in front of you, and a bookshelf to the north. There is a red book on the shelf, with gold lettering. It says The Kings Court. </value>
        </item>
      </descriptions>
      <description type="script">
        PrintRoomDesc (False)
      </description>
      <exit name="South58" alias="south" to="defaultroom">
        <inherit name="southdirection" />
        <runscript />
        <script type="script">
          MoveAndFace (library5, 2)
        </script>
      </exit>
      <exit name="East73" alias="east" to="defaultroom">
        <inherit name="eastdirection" />
        <runscript />
        <script type="script">
          MoveAndFace (library17, 1)
        </script>
      </exit>
    </object>
    <object name="library7">
      <inherit name="editor_room" />
      <usedefaultprefix />
      <descriptions type="stringdictionary">
        <item>
          <key>darknorth</key>
          <value>You cannot see anything. You feel as if you have faded into the darkness. </value>
        </item>
        <item>
          <key>darkeast</key>
          <value>You cannot see anything. You feel as if you have faded into the darkness.</value>
        </item>
        <item>
          <key>darksouth</key>
          <value>You cannot see anything. You feel as if you have faded into the darkness. You can feel a bookshelf in front of you.</value>
        </item>
        <item>
          <key>darkwest</key>
          <value>You cannot see anything. You feel as if you have faded into the darkness. You can feel a wall in front of you.</value>
        </item>
        <item>
          <key>dimnorth</key>
          <value>There is a wall to the west of you.</value>
        </item>
        <item>
          <key>dimeast</key>
          <value>There is a bookshelf to the south of you.</value>
        </item>
        <item>
          <key>dimsouth</key>
          <value>There is a bookshelf in front of you, and a wall to the west.</value>
        </item>
        <item>
          <key>dimwest</key>
          <value>There is a wall in front of you.</value>
        </item>
        <item>
          <key>brightnorth</key>
          <value>There is a wall to the west of you, the path continues forwards, and to the east.</value>
        </item>
        <item>
          <key>brighteast</key>
          <value>There is a bookshelf to the south of you. The path continues forwards. </value>
        </item>
        <item>
          <key>brightsouth</key>
          <value>There is a bookshelf in front of you, and a wall to the west. The path continues to the east.</value>
        </item>
        <item>
          <key>brightwest</key>
          <value>There is a wall in front of you, the path continues to the north.</value>
        </item>
      </descriptions>
      <description type="script">
        PrintRoomDesc (False)
      </description>
      <exit name="East77" alias="east" to="defaultroom">
        <inherit name="eastdirection" />
        <runscript />
        <script type="script">
          MoveAndFace (library19, 1)
        </script>
      </exit>
      <exit name="North103" alias="north" to="defaultroom">
        <inherit name="northdirection" />
        <runscript />
        <script type="script">
          MoveAndFace (library8, 0)
        </script>
      </exit>
    </object>
    <object name="library8">
      <inherit name="editor_room" />
      <usedefaultprefix />
      <descriptions type="stringdictionary">
        <item>
          <key>darknorth</key>
          <value>You cannot see anything. You feel as if you have faded into the darkness. </value>
        </item>
        <item>
          <key>darkeast</key>
          <value>You cannot see anything. You feel as if you have faded into the darkness. You can feel a bookshelf in front of you.</value>
        </item>
        <item>
          <key>darksouth</key>
          <value>You cannot see anything. You feel as if you have faded into the darkness.</value>
        </item>
        <item>
          <key>darkwest</key>
          <value>You cannot see anything. You feel as if you have faded into the darkness. You can feel a wall in front of you.</value>
        </item>
        <item>
          <key>dimnorth</key>
          <value>There is a wall to the west of you, and a bookshelf to the east. </value>
        </item>
        <item>
          <key>dimeast</key>
          <value>There is a bookshelf in front of you. </value>
        </item>
        <item>
          <key>dimsouth</key>
          <value>There is a bookshelf to the east of you, and a wall to the west. </value>
        </item>
        <item>
          <key>dimwest</key>
          <value>There is a wall in front of you.</value>
        </item>
        <item>
          <key>brightnorth</key>
          <value>There is a wall to the west of you, and a bookshelf to the east. The path continues forwards.</value>
        </item>
        <item>
          <key>brighteast</key>
          <value>There is a bookshelf in front of you, the path continues to the north, and the south.</value>
        </item>
        <item>
          <key>brightsouth</key>
          <value>There is a bookshelf to the east of you, and a wall to the west. The path continues forwards.</value>
        </item>
        <item>
          <key>brightwest</key>
          <value>There is a wall in front of you. The path continues to the south, and the north.</value>
        </item>
      </descriptions>
      <description type="script">
        PrintRoomDesc (False)
      </description>
      <exit name="South96" alias="south" to="defaultroom">
        <inherit name="southdirection" />
        <runscript />
        <script type="script">
          MoveAndFace (library7, 2)
        </script>
      </exit>
      <exit name="North117" alias="north" to="defaultroom">
        <inherit name="northdirection" />
        <runscript />
        <script type="script">
          MoveAndFace (library9, 0)
        </script>
      </exit>
    </object>
    <object name="library9">
      <inherit name="editor_room" />
      <usedefaultprefix />
      <descriptions type="stringdictionary">
        <item>
          <key>darknorth</key>
          <value>You cannot see anything. You feel as if you have faded into the darkness. </value>
        </item>
        <item>
          <key>darkeast</key>
          <value>You cannot see anything. You feel as if you have faded into the darkness. You can feel a bookshelf in front of you.</value>
        </item>
        <item>
          <key>darksouth</key>
          <value>You cannot see anything. You feel as if you have faded into the darkness.</value>
        </item>
        <item>
          <key>darkwest</key>
          <value>You cannot see anything. You feel as if you have faded into the darkness.</value>
        </item>
        <item>
          <key>dimnorth</key>
          <value>There is a bookshelf to the east of you, there is a dead end a step forwards.</value>
        </item>
        <item>
          <key>dimeast</key>
          <value>There is a bookshelf in front of you, it is dusty. None of the books stand out to you.</value>
        </item>
        <item>
          <key>dimsouth</key>
          <value>There is a bookshelf to the east of you. The path continues to the south, and west of you.</value>
        </item>
        <item>
          <key>dimwest</key>
          <value>The path continues forwards, to the north and to the south. </value>
        </item>
        <item>
          <key>brightnorth</key>
          <value>There is a bookshelf to the east of you, there is a dead end a step forwards. The path continues to the west of you.</value>
        </item>
        <item>
          <key>brighteast</key>
          <value>There is a bookshelf in front of you, it is dusty. None of the books stand out to you. The path continues to the south, and north of you.</value>
        </item>
        <item>
          <key>brightsouth</key>
          <value>There is a bookshelf to the east of you. The path continues to the south, and west of you. </value>
        </item>
        <item>
          <key>brightwest</key>
          <value>The path continues forwards, to the north and to the south. There is a dead end to the north, however. </value>
        </item>
      </descriptions>
      <description type="script">
        PrintRoomDesc (False)
      </description>
      <exit name="West83" alias="west" to="defaultroom">
        <inherit name="westdirection" />
        <runscript />
        <visible />
        <script type="script">
          MoveAndFace (library2, 3)
        </script>
      </exit>
      <exit name="South100" alias="south" to="defaultroom">
        <inherit name="southdirection" />
        <runscript />
        <script type="script">
          MoveAndFace (library8, 2)
        </script>
      </exit>
      <exit name="North124" alias="north" to="defaultroom">
        <inherit name="northdirection" />
        <runscript />
        <script type="script">
          MoveAndFace (library10, 0)
        </script>
      </exit>
    </object>
    <object name="library10">
      <inherit name="editor_room" />
      <usedefaultprefix />
      <descriptions type="stringdictionary">
        <item>
          <key>darknorth</key>
          <value>You cannot see anything. You feel as if you have faded into the darkness. You can feel a bookshelf in front of you.</value>
        </item>
        <item>
          <key>darkeast</key>
          <value>You cannot see anything. You feel as if you have faded into the darkness. You can feel a bookshelf in front of you.</value>
        </item>
        <item>
          <key>darksouth</key>
          <value>You cannot see anything. You feel as if you have faded into the darkness.</value>
        </item>
        <item>
          <key>darkwest</key>
          <value>You cannot see anything. You feel as if you have faded into the darkness. You can feel a wall in front of you.</value>
        </item>
        <item>
          <key>dimnorth</key>
          <value>There is a bookshelf in front of you, and a wall to the west. This is a dead end.</value>
        </item>
        <item>
          <key>dimeast</key>
          <value>There is a bookshelf in front of you. This is a dead end, the path continues to the south.</value>
        </item>
        <item>
          <key>dimsouth</key>
          <value>There is a bookshelf to the east of you, and a wall to the west. </value>
        </item>
        <item>
          <key>dimwest</key>
          <value>There is a wall in front of you, and a bookshelf to the north. This is a dead end.</value>
        </item>
        <item>
          <key>brightnorth</key>
          <value>There is a bookshelf in front of you, and a wall to the west. This is a dead end.</value>
        </item>
        <item>
          <key>brighteast</key>
          <value>There is a bookshelf in front of you. This is a dead end, the path continues to the south.</value>
        </item>
        <item>
          <key>brightsouth</key>
          <value>There is a bookshelf to the east of you, and a wall to the west. The path continues forwards.</value>
        </item>
        <item>
          <key>brightwest</key>
          <value>There is a wall in front of you, and a bookshelf to the north. This is a dead end. The path continues to the south.</value>
        </item>
      </descriptions>
      <description type="script">
        PrintRoomDesc (False)
      </description>
      <exit name="South101" alias="south" to="defaultroom">
        <inherit name="southdirection" />
        <runscript />
        <script type="script">
          MoveAndFace (library9, 2)
        </script>
      </exit>
    </object>
    <object name="library11">
      <inherit name="editor_room" />
      <usedefaultprefix />
      <descriptions type="stringdictionary">
        <item>
          <key>darknorth</key>
          <value>You cannot see anything. You feel as if you have faded into the darkness. </value>
        </item>
        <item>
          <key>darkeast</key>
          <value>You cannot see anything. You feel as if you have faded into the darkness.</value>
        </item>
        <item>
          <key>darksouth</key>
          <value>You cannot see anything. You feel as if you have faded into the darkness. You can feel a bookshelf in front of you.</value>
        </item>
        <item>
          <key>darkwest</key>
          <value>You cannot see anything. You feel as if you have faded into the darkness. You can feel a wall in front of you.</value>
        </item>
        <item>
          <key>dimnorth</key>
          <value>There is a wall to the west of you. The path continues forwards, and to the east.</value>
        </item>
        <item>
          <key>dimeast</key>
          <value>There is a bookshelf to the south of you. The path continues forwards. </value>
        </item>
        <item>
          <key>dimsouth</key>
          <value>There is a bookshelf in front of you, and a wall to the west.</value>
        </item>
        <item>
          <key>dimwest</key>
          <value>There is a wall in front of you, and a bookshelf to the south.</value>
        </item>
        <item>
          <key>brightnorth</key>
          <value>There is a wall to the west of you. The path continues forwards, and to the east.</value>
        </item>
        <item>
          <key>brighteast</key>
          <value>There is a bookshelf to the south of you. The path continues forwards.</value>
        </item>
        <item>
          <key>brightsouth</key>
          <value>There is a bookshelf in front of you, and a wall to the west. The path continues to the east. </value>
        </item>
        <item>
          <key>brightwest</key>
          <value>There is a wall in front of you, and a bookshelf to the south. The path continues to the north.</value>
        </item>
      </descriptions>
      <description type="script">
        PrintRoomDesc (False)
      </description>
      <exit name="East91" alias="east" to="defaultroom">
        <inherit name="eastdirection" />
        <runscript />
        <script type="script">
          MoveAndFace (library20, 1)
        </script>
      </exit>
      <exit name="North130" alias="north" to="defaultroom">
        <inherit name="northdirection" />
        <runscript />
        <script type="script">
          MoveAndFace (library12, 0)
        </script>
      </exit>
    </object>
    <object name="library12">
      <inherit name="editor_room" />
      <usedefaultprefix />
      <descriptions type="stringdictionary">
        <item>
          <key>darknorth</key>
          <value>You cannot see anything. You feel as if you have faded into the darkness. </value>
        </item>
        <item>
          <key>darkeast</key>
          <value>You cannot see anything. You feel as if you have faded into the darkness. You can feel a bookshelf in front of you.</value>
        </item>
        <item>
          <key>darksouth</key>
          <value>You cannot see anything. You feel as if you have faded into the darkness.</value>
        </item>
        <item>
          <key>darkwest</key>
          <value>You cannot see anything. You feel as if you have faded into the darkness. You can feel a wall in front of you.</value>
        </item>
        <item>
          <key>dimnorth</key>
          <value>There is a bookshelf to the east of you, and a wall to the west. </value>
        </item>
        <item>
          <key>dimeast</key>
          <value>There is a bookshelf in front of you. The path continues to the south, and north.</value>
        </item>
        <item>
          <key>dimsouth</key>
          <value>There is a wall to the west, and a bookshelf to the east. </value>
        </item>
        <item>
          <key>dimwest</key>
          <value>There is a wall in front of you. The path continues to the south, and the north. </value>
        </item>
        <item>
          <key>brightnorth</key>
          <value>There is a bookshelf to the east of you, and a wall to the west. The path continues forwards.</value>
        </item>
        <item>
          <key>brighteast</key>
          <value>There is a bookshelf in front of you. The path continues to the south, and north.</value>
        </item>
        <item>
          <key>brightsouth</key>
          <value>There is a wall to the west, and a bookshelf to the east. The path turns a step forwards.</value>
        </item>
        <item>
          <key>brightwest</key>
          <value>There is a wall in front of you. The path continues to the south, and the north. </value>
        </item>
      </descriptions>
      <description type="script">
        PrintRoomDesc (False)
      </description>
      <exit name="South112" alias="south" to="defaultroom">
        <inherit name="southdirection" />
        <runscript />
        <script type="script">
          MoveAndFace (library11, 2)
        </script>
      </exit>
      <exit name="North131" alias="north" to="defaultroom">
        <inherit name="northdirection" />
        <runscript />
        <script type="script">
          MoveAndFace (library13, 0)
        </script>
      </exit>
    </object>
    <object name="library13">
      <inherit name="editor_room" />
      <usedefaultprefix />
      <descriptions type="stringdictionary">
        <item>
          <key>darknorth</key>
          <value>You cannot see anything. You feel as if you have faded into the darkness. </value>
        </item>
        <item>
          <key>darkeast</key>
          <value>You cannot see anything. You feel as if you have faded into the darkness. You can feel a bookshelf in front of you.</value>
        </item>
        <item>
          <key>darksouth</key>
          <value>You cannot see anything. You feel as if you have faded into the darkness.</value>
        </item>
        <item>
          <key>darkwest</key>
          <value>You cannot see anything. You feel as if you have faded into the darkness. You can feel a wall in front of you.</value>
        </item>
        <item>
          <key>dimnorth</key>
          <value>There is a wall to the west of you, and a bookshelf to the east. The bookshelf has a blue book on it.</value>
        </item>
        <item>
          <key>dimeast</key>
          <value>There is a bookshelf in front of you. There is a blue book on it, it has Kings Quarters written in black lettering on the spine.</value>
        </item>
        <item>
          <key>dimsouth</key>
          <value>There is a wall to the west, and a bookshelf to the east. There is a blue book on the shelf.</value>
        </item>
        <item>
          <key>dimwest</key>
          <value>There is a wall in front of you. The path continues to the south, and the north.</value>
        </item>
        <item>
          <key>brightnorth</key>
          <value>There is a wall to the west of you, and a bookshelf to the east. The path continues forwards. The bookshelf has a blue book on it, it is called the Kings Quarters. </value>
        </item>
        <item>
          <key>brighteast</key>
          <value>There is a bookshelf in front of you. There is a blue book on it, it has Kings Quarters written in black lettering on the spine.</value>
        </item>
        <item>
          <key>brightsouth</key>
          <value>There is a wall to the west, and a bookshelf to the east. There is a blue book on the shelf. It says Kings Quarters in black lettering on the spine.</value>
        </item>
        <item>
          <key>brightwest</key>
          <value>There is a wall in front of you. The path continues to the south, and the north.</value>
        </item>
      </descriptions>
      <description type="script">
        PrintRoomDesc (False)
      </description>
      <exit name="South116" alias="south" to="defaultroom">
        <inherit name="southdirection" />
        <runscript />
        <script type="script">
          MoveAndFace (library12, 2)
        </script>
      </exit>
      <exit name="North132" alias="north" to="defaultroom">
        <inherit name="northdirection" />
        <runscript />
        <script type="script">
          MoveAndFace (library14, 0)
        </script>
      </exit>
    </object>
    <object name="library14">
      <inherit name="editor_room" />
      <usedefaultprefix />
      <descriptions type="stringdictionary">
        <item>
          <key>darknorth</key>
          <value>You cannot see anything. You feel as if you have faded into the darkness. </value>
        </item>
        <item>
          <key>darkeast</key>
          <value>You cannot see anything. You feel as if you have faded into the darkness. You can feel a bookshelf in front of you.</value>
        </item>
        <item>
          <key>darksouth</key>
          <value>You cannot see anything. You feel as if you have faded into the darkness.</value>
        </item>
        <item>
          <key>darkwest</key>
          <value>You cannot see anything. You feel as if you have faded into the darkness. You can feel a wall in front of you.</value>
        </item>
        <item>
          <key>dimnorth</key>
          <value>There is a wall to the west, and a bookshelf to the east.</value>
        </item>
        <item>
          <key>dimeast</key>
          <value>There is a bookshelf in front of you. The path continues to the south, and the north.</value>
        </item>
        <item>
          <key>dimsouth</key>
          <value>There is a wall to the west, and a bookshelf to the south.</value>
        </item>
        <item>
          <key>dimwest</key>
          <value>There is a wall in front of you.</value>
        </item>
        <item>
          <key>brightnorth</key>
          <value>There is a wall to the west, and a bookshelf to the east. There is a small table up ahead that seems to have something on it. </value>
        </item>
        <item>
          <key>brighteast</key>
          <value>There is a bookshelf in front of you. The path continues to the south, and the north.</value>
        </item>
        <item>
          <key>brightsouth</key>
          <value>There is a wall to the west, and a bookshelf to the south. The path continues forwards.</value>
        </item>
        <item>
          <key>brightwest</key>
          <value>There is a wall in front of you. The path continues to the south and north. </value>
        </item>
      </descriptions>
      <description type="script">
        PrintRoomDesc (False)
      </description>
      <exit name="South124" alias="south" to="defaultroom">
        <inherit name="southdirection" />
        <runscript />
        <script type="script">
          MoveAndFace (library13, 2)
        </script>
      </exit>
      <exit name="North134" alias="north" to="defaultroom">
        <inherit name="northdirection" />
        <runscript />
        <script type="script">
          MoveAndFace (library15, 0)
        </script>
      </exit>
    </object>
    <object name="library15">
      <inherit name="editor_room" />
      <usedefaultprefix />
      <descriptions type="stringdictionary">
        <item>
          <key>darknorth</key>
          <value>You cannot see anything. You feel as if you have faded into the darkness. You can feel a small table in front of you.</value>
        </item>
        <item>
          <key>darkeast</key>
          <value>You cannot see anything. You feel as if you have faded into the darkness. You can feel a bookshelf in front of you.</value>
        </item>
        <item>
          <key>darksouth</key>
          <value>You cannot see anything. You feel as if you have faded into the darkness.</value>
        </item>
        <item>
          <key>darkwest</key>
          <value>You cannot see anything. You feel as if you have faded into the darkness. You can feel a wall in front of you.</value>
        </item>
        <item>
          <key>dimnorth</key>
          <value>There is a table in front of you. There is a wall to the west, and a bookshelf to the east.</value>
        </item>
        <item>
          <key>dimeast</key>
          <value>There is a bookshelf in front of you, and a small table to the north.</value>
        </item>
        <item>
          <key>dimsouth</key>
          <value>There is a wall to the west of you, and a bookshelf to the east.</value>
        </item>
        <item>
          <key>dimwest</key>
          <value>There is a wall in front of you, there is a small table to the north of you.</value>
        </item>
        <item>
          <key>brightnorth</key>
          <value>There is a table in front of you. There is a wall to the west, and a bookshelf to the east. This is a dead end. </value>
        </item>
        <item>
          <key>brighteast</key>
          <value>There is a bookshelf in front of you, and a small table. This is a dead end, the path continues to the south.  </value>
        </item>
        <item>
          <key>brightsouth</key>
          <value>There is a wall to the west of you, and a bookshelf to the east. The path continues forwards. </value>
        </item>
        <item>
          <key>brightwest</key>
          <value>There is a wall in front of you, there is a small table to the north of you.</value>
        </item>
      </descriptions>
      <description type="script"><![CDATA[
        PrintRoomDesc (False)
        if (not oil7.parent = null and lantern.light_level > 0) {
          if (player.facing_num = 0) {
            msg ("There is a cask of oil sitting on the table in front of you.")
          }
          else if (player.facing_num <> 2) {
            msg ("There is a cask of oil sitting on the table to the north.")
          }
        }
      ]]></description>
      <exit name="South134" alias="south" to="defaultroom">
        <inherit name="southdirection" />
        <runscript />
        <script type="script">
          MoveAndFace (library14, 2)
        </script>
      </exit>
      <object name="oil7">
        <inherit name="editor_object" />
        <alt type="stringlist">
          <value>cask</value>
        </alt>
        <alias>oil</alias>
        <scenery />
        <feature_usegive />
        <take type="script">
          GetOil (oil7)
        </take>
        <use type="script">
          GetOil (oil7)
        </use>
      </object>
    </object>
    <object name="library17">
      <inherit name="editor_room" />
      <usedefaultprefix />
      <descriptions type="stringdictionary">
        <item>
          <key>darknorth</key>
          <value>You cannot see anything. You feel as if you have faded into the darkness. </value>
        </item>
        <item>
          <key>darkeast</key>
          <value>You cannot see anything. You feel as if you have faded into the darkness.</value>
        </item>
        <item>
          <key>darksouth</key>
          <value>You cannot see anything. You feel as if you have faded into the darkness. You can feel a bookshelf in front of you.</value>
        </item>
        <item>
          <key>darkwest</key>
          <value>You cannot see anything. You feel as if you have faded into the darkness.</value>
        </item>
        <item>
          <key>dimnorth</key>
          <value>You are at a fork in the path, it continues forwards, to the west, and to the east.</value>
        </item>
        <item>
          <key>dimeast</key>
          <value>There is a bookshelf to the south of you. The path continues forwards, and to the north.</value>
        </item>
        <item>
          <key>dimsouth</key>
          <value>There is a bookshelf in front of you, all the books are black, and have no writing on them.</value>
        </item>
        <item>
          <key>dimwest</key>
          <value>There is a bookshelf to the south of you. The path continues forwards, and to the north of you. </value>
        </item>
        <item>
          <key>brightnorth</key>
          <value>You are at a fork in the path, it continues forwards, to the west, and to the east.</value>
        </item>
        <item>
          <key>brighteast</key>
          <value>There is a bookshelf to the south of you. The path continues forwards, and to the north.</value>
        </item>
        <item>
          <key>brightsouth</key>
          <value>There is a bookshelf in front of you, all the books are black, and have no writing on them. The path continues to the west, and the east of you. </value>
        </item>
        <item>
          <key>brightwest</key>
          <value>There is a bookshelf to the south of you. The path continues forwards, and to the north of you.</value>
        </item>
      </descriptions>
      <description type="script">
        PrintRoomDesc (False)
      </description>
      <exit name="West124" alias="west" to="defaultroom">
        <inherit name="westdirection" />
        <runscript />
        <visible />
        <script type="script">
          MoveAndFace (library6, 3)
        </script>
      </exit>
      <exit name="East125" alias="east" to="defaultroom">
        <inherit name="eastdirection" />
        <runscript />
        <script type="script">
          MoveAndFace (library24, 1)
        </script>
      </exit>
      <exit name="North148" alias="north" to="defaultroom">
        <inherit name="northdirection" />
        <runscript />
        <script type="script">
          MoveAndFace (library18, 0)
        </script>
      </exit>
    </object>
    <object name="library18">
      <inherit name="editor_room" />
      <usedefaultprefix />
      <descriptions type="stringdictionary">
        <item>
          <key>darknorth</key>
          <value>You cannot see anything. You feel as if you have faded into the darkness. </value>
        </item>
        <item>
          <key>darkeast</key>
          <value>You cannot see anything. You feel as if you have faded into the darkness. You can feel a bookshelf in front of you.</value>
        </item>
        <item>
          <key>darksouth</key>
          <value>You cannot see anything. You feel as if you have faded into the darkness.</value>
        </item>
        <item>
          <key>darkwest</key>
          <value>You cannot see anything. You feel as if you have faded into the darkness. You can feel a bookshelf in front of you.</value>
        </item>
        <item>
          <key>dimnorth</key>
          <value>There is a bookshelf to the west, and to the east of you. </value>
        </item>
        <item>
          <key>dimeast</key>
          <value>There is a bookshelf in front of you.</value>
        </item>
        <item>
          <key>dimsouth</key>
          <value>There is a bookshelf to the west, and the east of you. </value>
        </item>
        <item>
          <key>dimwest</key>
          <value>There is a bookshelf in front of you. </value>
        </item>
        <item>
          <key>brightnorth</key>
          <value>There is a bookshelf to the west, and to the east of you. The path continues forwards, but branches off up ahead. </value>
        </item>
        <item>
          <key>brighteast</key>
          <value>There is a bookshelf in front of you, the path continues to the south, and the north of you.</value>
        </item>
        <item>
          <key>brightsouth</key>
          <value>There is a bookshelf to the west, and the east of you. The path continues forwards, but then branches off. </value>
        </item>
        <item>
          <key>brightwest</key>
          <value>There is a bookshelf in front of you. The path continues to the south, and north of you. </value>
        </item>
      </descriptions>
      <description type="script">
        PrintRoomDesc (False)
      </description>
      <exit name="South144" alias="south" to="defaultroom">
        <inherit name="southdirection" />
        <runscript />
        <script type="script">
          MoveAndFace (library17, 2)
        </script>
      </exit>
      <exit name="North150" alias="north" to="defaultroom">
        <inherit name="northdirection" />
        <runscript />
        <script type="script">
          MoveAndFace (library19, 0)
        </script>
      </exit>
    </object>
    <object name="library19">
      <inherit name="editor_room" />
      <usedefaultprefix />
      <descriptions type="stringdictionary">
        <item>
          <key>darknorth</key>
          <value>You cannot see anything. You feel as if you have faded into the darkness. You can feel a bookshelf in front of you.</value>
        </item>
        <item>
          <key>darkeast</key>
          <value>You cannot see anything. You feel as if you have faded into the darkness.</value>
        </item>
        <item>
          <key>darksouth</key>
          <value>You cannot see anything. You feel as if you have faded into the darkness.</value>
        </item>
        <item>
          <key>darkwest</key>
          <value>You cannot see anything. You feel as if you have faded into the darkness.</value>
        </item>
        <item>
          <key>dimnorth</key>
          <value>There is a bookshelf in front of you. </value>
        </item>
        <item>
          <key>dimeast</key>
          <value>There is a bookshelf to the north of you.</value>
        </item>
        <item>
          <key>dimsouth</key>
          <value>You are at a fork in the path. The path continues forwards, to the west, and to the east of you.</value>
        </item>
        <item>
          <key>dimwest</key>
          <value>There is a bookshelf to the east of you. The path continues forwards, and to the south of you.</value>
        </item>
        <item>
          <key>brightnorth</key>
          <value>There is a bookshelf in front of you. The path continues to the west, and the east of you. </value>
        </item>
        <item>
          <key>brighteast</key>
          <value>There is a bookshelf to the north of you. The path continues forwards. </value>
        </item>
        <item>
          <key>brightsouth</key>
          <value>You are at a fork in the path. The path continues forwards, to the west, and to the east of you.</value>
        </item>
        <item>
          <key>brightwest</key>
          <value>There is a bookshelf to the east of you. The path continues forwards, and to the south of you.</value>
        </item>
      </descriptions>
      <description type="script">
        PrintRoomDesc (False)
      </description>
      <exit name="West128" alias="west" to="defaultroom">
        <inherit name="westdirection" />
        <runscript />
        <visible />
        <script type="script">
          MoveAndFace (library7, 3)
        </script>
      </exit>
      <exit name="South145" alias="south" to="defaultroom">
        <inherit name="southdirection" />
        <runscript />
        <script type="script">
          MoveAndFace (library18, 2)
        </script>
      </exit>
      <exit name="East129" alias="east" to="defaultroom">
        <inherit name="eastdirection" />
        <runscript />
        <script type="script">
          MoveAndFace (library25, 1)
        </script>
      </exit>
    </object>
    <object name="library20">
      <inherit name="editor_room" />
      <usedefaultprefix />
      <descriptions type="stringdictionary">
        <item>
          <key>darknorth</key>
          <value>You cannot see anything. You feel as if you have faded into the darkness. You can feel a bookshelf in front of you.</value>
        </item>
        <item>
          <key>darkeast</key>
          <value>You cannot see anything. You feel as if you have faded into the darkness.</value>
        </item>
        <item>
          <key>darksouth</key>
          <value>You cannot see anything. You feel as if you have faded into the darkness. You can feel a bookshelf in front of you.</value>
        </item>
        <item>
          <key>darkwest</key>
          <value>You cannot see anything. You feel as if you have faded into the darkness.</value>
        </item>
        <item>
          <key>dimnorth</key>
          <value>There is a bookshelf in front of you. </value>
        </item>
        <item>
          <key>dimeast</key>
          <value>There is a bookshelf to the south, and to the north of you.</value>
        </item>
        <item>
          <key>dimsouth</key>
          <value>There is a bookshelf in front of you. </value>
        </item>
        <item>
          <key>dimwest</key>
          <value>There is a bookshelf to the south, and north of you.</value>
        </item>
        <item>
          <key>brightnorth</key>
          <value>There is a bookshelf in front of you. The path continues to the west, and to the east of you. </value>
        </item>
        <item>
          <key>brighteast</key>
          <value>There is a bookshelf to the south, and to the north of you. There is a fork in the path ahead. </value>
        </item>
        <item>
          <key>brightsouth</key>
          <value>There is a bookshelf in front of you. The path continues to the west, and the east of you.</value>
        </item>
        <item>
          <key>brightwest</key>
          <value>There is a bookshelf to the south, and north of you. The path continues forwards. </value>
        </item>
      </descriptions>
      <description type="script">
        PrintRoomDesc (False)
      </description>
      <exit name="West129" alias="west" to="defaultroom">
        <inherit name="westdirection" />
        <runscript />
        <visible />
        <script type="script">
          MoveAndFace (library11, 3)
        </script>
      </exit>
      <exit name="East130" alias="east" to="defaultroom">
        <inherit name="eastdirection" />
        <runscript />
        <script type="script">
          MoveAndFace (library30, 1)
        </script>
      </exit>
    </object>
    <object name="library21">
      <inherit name="editor_room" />
      <usedefaultprefix />
      <descriptions type="stringdictionary">
        <item>
          <key>darknorth</key>
          <value>You cannot see anything. You feel as if you have faded into the darkness. </value>
        </item>
        <item>
          <key>darkeast</key>
          <value>You cannot see anything. You feel as if you have faded into the darkness.</value>
        </item>
        <item>
          <key>darksouth</key>
          <value>You cannot see anything. You feel as if you have faded into the darkness. You can feel a wall in front of you.</value>
        </item>
        <item>
          <key>darkwest</key>
          <value>You cannot see anything. You feel as if you have faded into the darkness. You can feel a bookshelf in front of you.</value>
        </item>
        <item>
          <key>dimnorth</key>
          <value>There is a bookshelf to the west of you. The path continues forwards.</value>
        </item>
        <item>
          <key>dimeast</key>
          <value>There is a wall to the south of you. The path continues forwards.</value>
        </item>
        <item>
          <key>dimsouth</key>
          <value>There is a wall in front of you, and a bookshelf to the west. </value>
        </item>
        <item>
          <key>dimwest</key>
          <value>There is a bookshelf to the south of you. The path continues forwards.</value>
        </item>
        <item>
          <key>brightnorth</key>
          <value>There is a bookshelf to the west of you. The path continues forwards.</value>
        </item>
        <item>
          <key>brighteast</key>
          <value>There is a wall to the south of you. The path continues forwards.</value>
        </item>
        <item>
          <key>brightsouth</key>
          <value>There is a wall in front of you, and a bookshelf to the west. You are in a corner, the path continues to the east of you. </value>
        </item>
        <item>
          <key>brightwest</key>
          <value>There is a bookshelf to the south of you. The path continues forwards.</value>
        </item>
      </descriptions>
      <description type="script">
        PrintRoomDesc (False)
      </description>
      <exit name="East131" alias="east" to="defaultroom">
        <inherit name="eastdirection" />
        <runscript />
        <script type="script">
          MoveAndFace (library33, 1)
        </script>
      </exit>
      <exit name="North155" alias="north" to="defaultroom">
        <inherit name="northdirection" />
        <runscript />
        <script type="script">
          MoveAndFace (library22, 0)
        </script>
      </exit>
    </object>
    <object name="library22">
      <inherit name="editor_room" />
      <usedefaultprefix />
      <descriptions type="stringdictionary">
        <item>
          <key>darknorth</key>
          <value>You cannot see anything. You feel as if you have faded into the darkness. </value>
        </item>
        <item>
          <key>darkeast</key>
          <value>You cannot see anything. You feel as if you have faded into the darkness. You can feel a bookshelf in front of you.</value>
        </item>
        <item>
          <key>darksouth</key>
          <value>You cannot see anything. You feel as if you have faded into the darkness.</value>
        </item>
        <item>
          <key>darkwest</key>
          <value>You cannot see anything. You feel as if you have faded into the darkness. You can feel a bookshelf in front of you.</value>
        </item>
        <item>
          <key>dimnorth</key>
          <value>There is a bookshelf to the east, and the west of you. The shelf to the west holds a white book that is noticeable amongst all the darkly coloured ones. </value>
        </item>
        <item>
          <key>dimeast</key>
          <value>There is a bookshelf in front of you.</value>
        </item>
        <item>
          <key>dimsouth</key>
          <value>There is a bookshelf to the east, and to the west of you. There is a book on the west shelf that is noticeable. It is white amongst a bunch of darkly coloured books.</value>
        </item>
        <item>
          <key>dimwest</key>
          <value>There is a bookshelf in front of you. A white book stands out amongst a shelf filled with darkly coloured books. It isnt of any importance, it is just noticeable.</value>
        </item>
        <item>
          <key>brightnorth</key>
          <value>There is a bookshelf to the east, and the west of you. The shelf to the west holds a white book that is noticeable amongst all the darkly coloured ones. The path continues forwards.</value>
        </item>
        <item>
          <key>brighteast</key>
          <value>There is a bookshelf in front of you, the path continues to the south, and to the north.</value>
        </item>
        <item>
          <key>brightsouth</key>
          <value>There is a bookshelf to the east, and to the west of you. There is a book on the west shelf that is noticeable. It is white amongst a bunch of darkly coloured books. The path continues forwards. </value>
        </item>
        <item>
          <key>brightwest</key>
          <value>There is a bookshelf in front of you. A white book stands out amongst a shelf filled with darkly coloured books. It isnt of any importance, it is just noticeable. The path continues to the south, and north of you.</value>
        </item>
      </descriptions>
      <description type="script">
        PrintRoomDesc (False)
      </description>
      <exit name="South156" alias="south" to="defaultroom">
        <inherit name="southdirection" />
        <runscript />
        <script type="script">
          MoveAndFace (library21, 2)
        </script>
      </exit>
      <exit name="North156" alias="north" to="defaultroom">
        <inherit name="northdirection" />
        <runscript />
        <script type="script">
          MoveAndFace (library23, 0)
        </script>
      </exit>
    </object>
    <object name="library23">
      <inherit name="editor_room" />
      <usedefaultprefix />
      <descriptions type="stringdictionary">
        <item>
          <key>darknorth</key>
          <value>You cannot see anything. You feel as if you have faded into the darkness. </value>
        </item>
        <item>
          <key>darkeast</key>
          <value>You cannot see anything. You feel as if you have faded into the darkness. You can feel a bookshelf in front of you.</value>
        </item>
        <item>
          <key>darksouth</key>
          <value>You cannot see anything. You feel as if you have faded into the darkness.</value>
        </item>
        <item>
          <key>darkwest</key>
          <value>You cannot see anything. You feel as if you have faded into the darkness. You can feel a bookshelf in front of you.</value>
        </item>
        <item>
          <key>dimnorth</key>
          <value>There is a bookshelf to the west, and the east of you. </value>
        </item>
        <item>
          <key>dimeast</key>
          <value>There is a bookshelf in front of you. </value>
        </item>
        <item>
          <key>dimsouth</key>
          <value>There is a bookshelf to the east, and the west of you.</value>
        </item>
        <item>
          <key>dimwest</key>
          <value>There is a bookshelf in front of you. </value>
        </item>
        <item>
          <key>brightnorth</key>
          <value>There is a bookshelf to the west, and the east of you. The path continues forwards.</value>
        </item>
        <item>
          <key>brighteast</key>
          <value>There is a bookshelf in front of you. The path continues to the south, and north of you.</value>
        </item>
        <item>
          <key>brightsouth</key>
          <value>There is a bookshelf to the east, and the west of you. The path continues forwards.</value>
        </item>
        <item>
          <key>brightwest</key>
          <value>There is a bookshelf in front of you. The path continues to the south, and north of you.</value>
        </item>
      </descriptions>
      <description type="script">
        PrintRoomDesc (False)
      </description>
      <exit name="South158" alias="south" to="defaultroom">
        <inherit name="southdirection" />
        <runscript />
        <script type="script">
          MoveAndFace (library22, 2)
        </script>
      </exit>
      <exit name="North157" alias="north" to="defaultroom">
        <inherit name="northdirection" />
        <runscript />
        <script type="script">
          MoveAndFace (library24, 0)
        </script>
      </exit>
    </object>
    <object name="library24">
      <inherit name="editor_room" />
      <usedefaultprefix />
      <descriptions type="stringdictionary">
        <item>
          <key>darknorth</key>
          <value>You cannot see anything. You feel as if you have faded into the darkness. You can feel a bookshelf in front of you.</value>
        </item>
        <item>
          <key>darkeast</key>
          <value>You cannot see anything. You feel as if you have faded into the darkness. You can feel a bookshelf in front of you.</value>
        </item>
        <item>
          <key>darksouth</key>
          <value>You cannot see anything. You feel as if you have faded into the darkness.</value>
        </item>
        <item>
          <key>darkwest</key>
          <value>You cannot see anything. You feel as if you have faded into the darkness.</value>
        </item>
        <item>
          <key>dimnorth</key>
          <value>There is a bookshelf in front of you, and a bookshelf to the east of you. You are in a corner.</value>
        </item>
        <item>
          <key>dimeast</key>
          <value>There is a bookshelf in front of you, and to the north of you. You are in a corner.</value>
        </item>
        <item>
          <key>dimsouth</key>
          <value>There is a bookshelf to the east of you.</value>
        </item>
        <item>
          <key>dimwest</key>
          <value>There is a bookshelf to the north of you.</value>
        </item>
        <item>
          <key>brightnorth</key>
          <value>There is a bookshelf in front of you, and a bookshelf to the east of you. You are in a corner. The path continues to the west. </value>
        </item>
        <item>
          <key>brighteast</key>
          <value>There is a bookshelf in front of you, and to the north of you. You are in a corner. The path continues to the south. </value>
        </item>
        <item>
          <key>brightsouth</key>
          <value>There is a bookshelf to the east of you. The path continues forwards.</value>
        </item>
        <item>
          <key>brightwest</key>
          <value>There is a bookshelf to the north of you. The path continues forwards. </value>
        </item>
      </descriptions>
      <description type="script">
        PrintRoomDesc (False)
      </description>
      <exit name="West138" alias="west" to="defaultroom">
        <inherit name="westdirection" />
        <runscript />
        <visible />
        <script type="script">
          MoveAndFace (library17, 3)
        </script>
      </exit>
      <exit name="South159" alias="south" to="defaultroom">
        <inherit name="southdirection" />
        <runscript />
        <script type="script">
          MoveAndFace (library23, 2)
        </script>
      </exit>
    </object>
    <object name="library25">
      <inherit name="editor_room" />
      <usedefaultprefix />
      <descriptions type="stringdictionary">
        <item>
          <key>darknorth</key>
          <value>You cannot see anything. You feel as if you have faded into the darkness. </value>
        </item>
        <item>
          <key>darkeast</key>
          <value>You cannot see anything. You feel as if you have faded into the darkness. You can feel a bookshelf in front of you.</value>
        </item>
        <item>
          <key>darksouth</key>
          <value>You cannot see anything. You feel as if you have faded into the darkness. You can feel a bookshelf in front of you.</value>
        </item>
        <item>
          <key>darkwest</key>
          <value>You cannot see anything. You feel as if you have faded into the darkness.</value>
        </item>
        <item>
          <key>dimnorth</key>
          <value>There is a bookshelf to the east of you. There is a faded orange book laying open on a mostly barren shelf. A phrase catches your eye, it reads: Their life is the energy that he feeds upon.</value>
        </item>
        <item>
          <key>dimeast</key>
          <value>There is a bookshelf in front of you, and to the south of you. On the shelf in front of you there is a faded orange book laying open on a mostly barren shelf. A phrase catches your eye, it reads: Their life is the energy that he obtains his immortality from.</value>
        </item>
        <item>
          <key>dimsouth</key>
          <value>There is a bookshelf in front of you, and to the east of you. The shelf to the east has an orange book, laying open on it. </value>
        </item>
        <item>
          <key>dimwest</key>
          <value>There is a bookshelf to the south of you.</value>
        </item>
        <item>
          <key>brightnorth</key>
          <value>There is a bookshelf to the east of you. There is a faded orange book laying open on a mostly barren shelf. A phrase catches your eye, it reads: Their life is the energy that he obtains his immortality from. The path continues forwards.</value>
        </item>
        <item>
          <key>brighteast</key>
          <value>There is a bookshelf in front of you, and to the south of you. On the shelf in front of you there is a faded orange book laying open on a mostly barren shelf. A phrase catches your eye, it reads: Their life is the energy that he obtains his immortality from. The path continues to the north.</value>
        </item>
        <item>
          <key>brightsouth</key>
          <value>There is a bookshelf in front of you, and to the east of you. The shelf to the east has an orange book, laying open on it. The path continues to the west of you.</value>
        </item>
        <item>
          <key>brightwest</key>
          <value>There is a bookshelf to the south of you. The path continues forwards.</value>
        </item>
      </descriptions>
      <description type="script">
        PrintRoomDesc (False)
      </description>
      <exit name="West139" alias="west" to="defaultroom">
        <inherit name="westdirection" />
        <runscript />
        <visible />
        <script type="script">
          MoveAndFace (library19, 3)
        </script>
      </exit>
      <exit name="North159" alias="north" to="defaultroom">
        <inherit name="northdirection" />
        <runscript />
        <script type="script">
          MoveAndFace (library26, 0)
        </script>
      </exit>
    </object>
    <object name="library26">
      <inherit name="editor_room" />
      <usedefaultprefix />
      <descriptions type="stringdictionary">
        <item>
          <key>darknorth</key>
          <value>You cannot see anything. You feel as if you have faded into the darkness. </value>
        </item>
        <item>
          <key>darkeast</key>
          <value>You cannot see anything. You feel as if you have faded into the darkness. You can feel a bookshelf in front of you.</value>
        </item>
        <item>
          <key>darksouth</key>
          <value>You cannot see anything. You feel as if you have faded into the darkness.</value>
        </item>
        <item>
          <key>darkwest</key>
          <value>You cannot see anything. You feel as if you have faded into the darkness. You can feel a bookshelf in front of you.</value>
        </item>
        <item>
          <key>dimnorth</key>
          <value>There is a bookshelf to the east, and to the west of you.</value>
        </item>
        <item>
          <key>dimeast</key>
          <value>There is a bookshelf in front of you.</value>
        </item>
        <item>
          <key>dimsouth</key>
          <value>There is a bookshelf to the east, and to the west of you. </value>
        </item>
        <item>
          <key>dimwest</key>
          <value>There is a bookshelf in front of you.</value>
        </item>
        <item>
          <key>brightnorth</key>
          <value>There is a bookshelf to the east, and to the west of you. The path continues forwards.</value>
        </item>
        <item>
          <key>brighteast</key>
          <value>There is a bookshelf in front of you. The path continues to the south, and north of you.</value>
        </item>
        <item>
          <key>brightsouth</key>
          <value>There is a bookshelf to the east, and to the west of you. The path continues forwards.</value>
        </item>
        <item>
          <key>brightwest</key>
          <value>There is a bookshelf in front of you. The path continues to the south, and north of you.</value>
        </item>
      </descriptions>
      <description type="script">
        PrintRoomDesc (False)
      </description>
      <exit name="South161" alias="south" to="defaultroom">
        <inherit name="southdirection" />
        <runscript />
        <script type="script">
          MoveAndFace (library25, 2)
        </script>
      </exit>
      <exit name="North160" alias="north" to="defaultroom">
        <inherit name="northdirection" />
        <runscript />
        <script type="script">
          MoveAndFace (library27, 0)
        </script>
      </exit>
    </object>
    <object name="library27">
      <inherit name="editor_room" />
      <usedefaultprefix />
      <descriptions type="stringdictionary">
        <item>
          <key>darknorth</key>
          <value>You cannot see anything. You feel as if you have faded into the darkness. </value>
        </item>
        <item>
          <key>darkeast</key>
          <value>You cannot see anything. You feel as if you have faded into the darkness. You can feel a bookshelf in front of you.</value>
        </item>
        <item>
          <key>darksouth</key>
          <value>You cannot see anything. You feel as if you have faded into the darkness.</value>
        </item>
        <item>
          <key>darkwest</key>
          <value>You cannot see anything. You feel as if you have faded into the darkness. You can feel a bookshelf in front of you.</value>
        </item>
        <item>
          <key>dimnorth</key>
          <value>There is a bookshelf to the east, and to the west of you.</value>
        </item>
        <item>
          <key>dimeast</key>
          <value>There is a bookshelf in front of you. </value>
        </item>
        <item>
          <key>dimsouth</key>
          <value>There is a bookshelf to the east, and to the west of you.</value>
        </item>
        <item>
          <key>dimwest</key>
          <value>There is a bookshelf in front of you. </value>
        </item>
        <item>
          <key>brightnorth</key>
          <value>There is a bookshelf to the east, and to the west of you. The path continues forwards. </value>
        </item>
        <item>
          <key>brighteast</key>
          <value>There is a bookshelf in front of you. The path continues to the south, and north of you.</value>
        </item>
        <item>
          <key>brightsouth</key>
          <value>There is a bookshelf to the east, and to the west of you. The path continues forwards.</value>
        </item>
        <item>
          <key>brightwest</key>
          <value>There is a bookshelf in front of you. The path continues to the south and north.</value>
        </item>
      </descriptions>
      <description type="script">
        PrintRoomDesc (False)
      </description>
      <exit name="South162" alias="south" to="defaultroom">
        <inherit name="southdirection" />
        <runscript />
        <script type="script">
          MoveAndFace (library26, 2)
        </script>
      </exit>
      <exit name="North161" alias="north" to="defaultroom">
        <inherit name="northdirection" />
        <runscript />
        <script type="script">
          MoveAndFace (library28, 0)
        </script>
      </exit>
    </object>
    <object name="library28">
      <inherit name="editor_room" />
      <usedefaultprefix />
      <descriptions type="stringdictionary">
        <item>
          <key>darknorth</key>
          <value>You cannot see anything. You feel as if you have faded into the darkness. </value>
        </item>
        <item>
          <key>darkeast</key>
          <value>You cannot see anything. You feel as if you have faded into the darkness.</value>
        </item>
        <item>
          <key>darksouth</key>
          <value>You cannot see anything. You feel as if you have faded into the darkness.</value>
        </item>
        <item>
          <key>darkwest</key>
          <value>You cannot see anything. You feel as if you have faded into the darkness. You can feel a bookshelf in front of you.</value>
        </item>
        <item>
          <key>dimnorth</key>
          <value>There is a bookshelf to the west of you. You are at a fork in the path, the path continues forwards, and to the east.</value>
        </item>
        <item>
          <key>dimeast</key>
          <value>The path continues forwards.</value>
        </item>
        <item>
          <key>dimsouth</key>
          <value>There is a bookshelf to the west of you. You are at a fork in the path, the path continues forwards, and to the east.</value>
        </item>
        <item>
          <key>dimwest</key>
          <value>There is a bookshelf in front of you. </value>
        </item>
        <item>
          <key>brightnorth</key>
          <value>There is a bookshelf to the west of you. You are at a fork in the path, the path continues forwards, and to the east.</value>
        </item>
        <item>
          <key>brighteast</key>
          <value>The path continues forwards.</value>
        </item>
        <item>
          <key>brightsouth</key>
          <value>There is a bookshelf to the west of you. You are at a fork in the path, the path continues forwards, and to the east.</value>
        </item>
        <item>
          <key>brightwest</key>
          <value>There is a bookshelf in front of you. The path continues to the south, and north of you.</value>
        </item>
      </descriptions>
      <description type="script">
        PrintRoomDesc (False)
      </description>
      <exit name="South163" alias="south" to="defaultroom">
        <inherit name="southdirection" />
        <runscript />
        <script type="script">
          MoveAndFace (library27, 2)
        </script>
      </exit>
      <exit name="East143" alias="east" to="defaultroom">
        <inherit name="eastdirection" />
        <runscript />
        <script type="script">
          MoveAndFace (library34, 1)
        </script>
      </exit>
      <exit name="North162" alias="north" to="defaultroom">
        <inherit name="northdirection" />
        <runscript />
        <script type="script">
          MoveAndFace (library29, 0)
        </script>
      </exit>
    </object>
    <object name="library29">
      <inherit name="editor_room" />
      <usedefaultprefix />
      <descriptions type="stringdictionary">
        <item>
          <key>darknorth</key>
          <value>You cannot see anything. You feel as if you have faded into the darkness. </value>
        </item>
        <item>
          <key>darkeast</key>
          <value>You cannot see anything. You feel as if you have faded into the darkness. You can feel a bookshelf in front of you.</value>
        </item>
        <item>
          <key>darksouth</key>
          <value>You cannot see anything. You feel as if you have faded into the darkness.</value>
        </item>
        <item>
          <key>darkwest</key>
          <value>You cannot see anything. You feel as if you have faded into the darkness. You can feel a bookshelf in front of you.</value>
        </item>
        <item>
          <key>dimnorth</key>
          <value>There is a bookshelf to the east, and west of you. On the bookshelf to the east, there is a thin purple book shoved beside a row of encyclopaedias. </value>
        </item>
        <item>
          <key>dimeast</key>
          <value>There is a bookshelf in front of you. On it there is a row of encyclopaedias, and in the middle there is a thin purple book. It isnt that interesting, just out of place.</value>
        </item>
        <item>
          <key>dimsouth</key>
          <value>There is a bookshelf to the west, and to the east of you. The shelf to the east has a thin purple book in the middle of a row of encyclopaedias. It doesnt seem like an interesting book, just out of place.</value>
        </item>
        <item>
          <key>dimwest</key>
          <value>There is a bookshelf in front of you.</value>
        </item>
        <item>
          <key>brightnorth</key>
          <value>There is a bookshelf to the east, and west of you. On the bookshelf to the east, there is a thin purple book shoved inside a row of encyclopaedias. It doesnt seem that interesting of a book, just out of place. The path continues forwards.</value>
        </item>
        <item>
          <key>brighteast</key>
          <value>There is a bookshelf in front of you. On it there is a row of encyclopaedias, and in the middle there is a thin purple book. It isnt that interesting, just out of place. The path continues to the south, and north of you.</value>
        </item>
        <item>
          <key>brightsouth</key>
          <value>There is a bookshelf to the west, and to the east of you. The shelf to the east has a thin purple book in the middle of a row of encyclopaedias. It doesnt seem like an interesting book, just out of place. The path continues forwards. </value>
        </item>
        <item>
          <key>brightwest</key>
          <value>There is a bookshelf in front of you. The path continues to the north, and to the south.</value>
        </item>
      </descriptions>
      <description type="script">
        PrintRoomDesc (False)
      </description>
      <exit name="South164" alias="south" to="defaultroom">
        <inherit name="southdirection" />
        <runscript />
        <script type="script">
          MoveAndFace (library28, 2)
        </script>
      </exit>
      <exit name="North163" alias="north" to="defaultroom">
        <inherit name="northdirection" />
        <runscript />
        <script type="script">
          MoveAndFace (library30, 0)
        </script>
      </exit>
    </object>
    <object name="library30">
      <inherit name="editor_room" />
      <usedefaultprefix />
      <descriptions type="stringdictionary">
        <item>
          <key>darknorth</key>
          <value>You cannot see anything. You feel as if you have faded into the darkness. </value>
        </item>
        <item>
          <key>darkeast</key>
          <value>TODO: implement this description</value>
        </item>
        <item>
          <key>darksouth</key>
          <value>You cannot see anything. You feel as if you have faded into the darkness.</value>
        </item>
        <item>
          <key>darkwest</key>
          <value>You cannot see anything. You feel as if you have faded into the darkness.</value>
        </item>
        <item>
          <key>dimnorth</key>
          <value>There is a bookshelf to the east of you.</value>
        </item>
        <item>
          <key>dimeast</key>
          <value>TODO: implement this description</value>
        </item>
        <item>
          <key>dimsouth</key>
          <value>There is a bookshelf to the east of you. </value>
        </item>
        <item>
          <key>dimwest</key>
          <value>You are at a fork in the path. The path continues forwards, to the south, and the north. </value>
        </item>
        <item>
          <key>brightnorth</key>
          <value>There is a bookshelf to the east of you. The path continues to the north, and south of you.</value>
        </item>
        <item>
          <key>brighteast</key>
          <value>TODO: implement this description</value>
        </item>
        <item>
          <key>brightsouth</key>
          <value>There is a bookshelf to the east of you. The path continues forwards.</value>
        </item>
        <item>
          <key>brightwest</key>
          <value>You are at a fork in the path. The path continues forwards, to the south, and the north.</value>
        </item>
      </descriptions>
      <description type="script">
        PrintRoomDesc (False)
      </description>
      <exit name="West145" alias="west" to="defaultroom">
        <inherit name="westdirection" />
        <runscript />
        <visible />
        <script type="script">
          MoveAndFace (library20, 3)
        </script>
      </exit>
      <exit name="South165" alias="south" to="defaultroom">
        <inherit name="southdirection" />
        <runscript />
        <script type="script">
          MoveAndFace (library29, 2)
        </script>
      </exit>
      <exit name="North164" alias="north" to="defaultroom">
        <inherit name="northdirection" />
        <runscript />
        <script type="script">
          MoveAndFace (library31, 0)
        </script>
      </exit>
    </object>
    <object name="library31">
      <inherit name="editor_room" />
      <usedefaultprefix />
      <descriptions type="stringdictionary">
        <item>
          <key>darknorth</key>
          <value>You cannot see anything. You feel as if you have faded into the darkness. </value>
        </item>
        <item>
          <key>darkeast</key>
          <value>You cannot see anything. You feel as if you have faded into the darkness. You can feel a bookshelf in front of you.</value>
        </item>
        <item>
          <key>darksouth</key>
          <value>You cannot see anything. You feel as if you have faded into the darkness.</value>
        </item>
        <item>
          <key>darkwest</key>
          <value>You cannot see anything. You feel as if you have faded into the darkness. You can feel a bookshelf in front of you.</value>
        </item>
        <item>
          <key>dimnorth</key>
          <value>There is a bookshelf to the east, and the west of you. The ground a step forwards looks weird.</value>
        </item>
        <item>
          <key>dimeast</key>
          <value>There is a bookshelf in front of you. The ground to the north of you looks weird.</value>
        </item>
        <item>
          <key>dimsouth</key>
          <value>There is a bookshelf to the east, and the west of you.</value>
        </item>
        <item>
          <key>dimwest</key>
          <value>There is a bookshelf in front of you. The ground to the north of you looks weird.</value>
        </item>
        <item>
          <key>brightnorth</key>
          <value>There is a bookshelf to the east, and the west of you. The ground a step forwards looks unstable. There also seems to be a dead end ahead.</value>
        </item>
        <item>
          <key>brighteast</key>
          <value>There is a bookshelf in front of you. The ground to the north of you looks unstable. The path continues to the south, and north, though the northern path seems to end soon.</value>
        </item>
        <item>
          <key>brightsouth</key>
          <value>There is a bookshelf to the east, and the west of you. The path continues forwards.</value>
        </item>
        <item>
          <key>brightwest</key>
          <value>There is a bookshelf in front of you, the path continues to the south, and to the north. The ground to the north of you looks weird.</value>
        </item>
      </descriptions>
      <description type="script">
        PrintRoomDesc (False)
      </description>
      <exit name="South166" alias="south" to="defaultroom">
        <inherit name="southdirection" />
        <runscript />
        <script type="script">
          MoveAndFace (library30, 2)
        </script>
      </exit>
      <exit name="North165" alias="north" to="defaultroom">
        <inherit name="northdirection" />
        <runscript />
        <script type="script">
          msg ("Your foot gets caught in a hole on the ground, and you crash into a bookshelf. You hear a screech and something rushes at you. It pushes you, and you go flying through the air. You land harshly on the ground, with the lantern still in hand, but now unlit. The creature seems to be satisfied, picks up the books all over the floor in one quick motion, and wanders off. You get up.")
          JumpScare
          lantern.light_level = 0
          lantern.fuel_level = lantern.fuel_level - 10
          FaceWest
          player.parent = library30
        </script>
      </exit>
    </object>
    <object name="library32">
      <inherit name="editor_room" />
      <usedefaultprefix />
      <descriptions type="stringdictionary">
        <item>
          <key>darknorth</key>
          <value>TODO: implement this description</value>
        </item>
        <item>
          <key>darkeast</key>
          <value>TODO: implement this description</value>
        </item>
        <item>
          <key>darksouth</key>
          <value>TODO: implement this description</value>
        </item>
        <item>
          <key>darkwest</key>
          <value>TODO: implement this description</value>
        </item>
        <item>
          <key>dimnorth</key>
          <value>TODO: implement this description</value>
        </item>
        <item>
          <key>dimeast</key>
          <value>TODO: implement this description</value>
        </item>
        <item>
          <key>dimsouth</key>
          <value>TODO: implement this description</value>
        </item>
        <item>
          <key>dimwest</key>
          <value>TODO: implement this description</value>
        </item>
        <item>
          <key>brightnorth</key>
          <value>TODO: implement this description</value>
        </item>
        <item>
          <key>brighteast</key>
          <value>TODO: implement this description</value>
        </item>
        <item>
          <key>brightsouth</key>
          <value>TODO: implement this description</value>
        </item>
        <item>
          <key>brightwest</key>
          <value>TODO: implement this description</value>
        </item>
        <item>
          <key>notes</key>
          <value>JK this isnt a real space, its a trap. It will push the player back 2 spaces. It should only tell the player that they have been pushed, but not how far.</value>
        </item>
      </descriptions>
      <description type="script">
      </description>
      <enter type="script">
      </enter>
      <beforeenter type="script">
      </beforeenter>
      <exit name="South167" alias="south" to="defaultroom">
        <inherit name="southdirection" />
        <runscript />
        <script type="script">
          MoveAndFace (library31, 2)
        </script>
      </exit>
    </object>
    <object name="library33">
      <inherit name="editor_room" />
      <usedefaultprefix />
      <descriptions type="stringdictionary">
        <item>
          <key>darknorth</key>
          <value>You cannot see anything. You feel as if you have faded into the darkness. You can feel a bookshelf in front of you.</value>
        </item>
        <item>
          <key>darkeast</key>
          <value>You cannot see anything. You feel as if you have faded into the darkness.</value>
        </item>
        <item>
          <key>darksouth</key>
          <value>You cannot see anything. You feel as if you have faded into the darkness. You can feel a wall in front of you.</value>
        </item>
        <item>
          <key>darkwest</key>
          <value>You cannot see anything. You feel as if you have faded into the darkness.</value>
        </item>
        <item>
          <key>dimnorth</key>
          <value>There is a bookshelf in front of you. </value>
        </item>
        <item>
          <key>dimeast</key>
          <value>There is a bookshelf to the north of you, and a wall to the south.</value>
        </item>
        <item>
          <key>dimsouth</key>
          <value>There is a wall in front of you. </value>
        </item>
        <item>
          <key>dimwest</key>
          <value>There is a wall to the south of you, and a bookshelf to the north. </value>
        </item>
        <item>
          <key>brightnorth</key>
          <value>There is a bookshelf in front of you. The path continues to the west, and to the east.</value>
        </item>
        <item>
          <key>brighteast</key>
          <value>There is a bookshelf to the north of you, and a wall to the south. The path continues forwards.</value>
        </item>
        <item>
          <key>brightsouth</key>
          <value>There is a wall in front of you. The path continues to the east, and the west. </value>
        </item>
        <item>
          <key>brightwest</key>
          <value>There is a wall to the south of you, and a bookshelf to the north. The path continues forwards.</value>
        </item>
      </descriptions>
      <description type="script">
        PrintRoomDesc (False)
      </description>
      <exit name="West152" alias="west" to="defaultroom">
        <inherit name="westdirection" />
        <runscript />
        <visible />
        <script type="script">
          MoveAndFace (library21, 3)
        </script>
      </exit>
      <exit name="East153" alias="east" to="defaultroom">
        <inherit name="eastdirection" />
        <runscript />
        <script type="script">
          MoveAndFace (library35, 1)
        </script>
      </exit>
    </object>
    <object name="library34">
      <inherit name="editor_room" />
      <usedefaultprefix />
      <descriptions type="stringdictionary">
        <item>
          <key>darknorth</key>
          <value>You cannot see anything. You feel as if you have faded into the darkness. You can feel a bookshelf in front of you.</value>
        </item>
        <item>
          <key>darkeast</key>
          <value>You cannot see anything. You feel as if you have faded into the darkness.</value>
        </item>
        <item>
          <key>darksouth</key>
          <value>You cannot see anything. You feel as if you have faded into the darkness. You can feel a bookshelf in front of you.</value>
        </item>
        <item>
          <key>darkwest</key>
          <value>You cannot see anything. You feel as if you have faded into the darkness.</value>
        </item>
        <item>
          <key>dimnorth</key>
          <value>There is a bookshelf in front of you.</value>
        </item>
        <item>
          <key>dimeast</key>
          <value>There is a bookshelf to the south, and north of you.</value>
        </item>
        <item>
          <key>dimsouth</key>
          <value>There is a bookshelf in front of you.</value>
        </item>
        <item>
          <key>dimwest</key>
          <value>There is a bookshelf to the south, and north of you.</value>
        </item>
        <item>
          <key>brightnorth</key>
          <value>There is a bookshelf in front of you. The path continues to the east, and west of you.</value>
        </item>
        <item>
          <key>brighteast</key>
          <value>There is a bookshelf to the south, and north of you. The path continues forwards into a small room. </value>
        </item>
        <item>
          <key>brightsouth</key>
          <value>There is a bookshelf in front of you. The path continues to the east, and to the west.</value>
        </item>
        <item>
          <key>brightwest</key>
          <value>There is a bookshelf to the south, and north of you. The path continues forwards.</value>
        </item>
      </descriptions>
      <description type="script">
        PrintRoomDesc (False)
      </description>
      <exit name="West153" alias="west" to="defaultroom">
        <inherit name="westdirection" />
        <runscript />
        <visible />
        <script type="script">
          MoveAndFace (library28, 3)
        </script>
      </exit>
      <exit name="East154" alias="east" to="defaultroom">
        <inherit name="eastdirection" />
        <runscript />
        <script type="script">
          MoveAndFace (library42, 1)
        </script>
      </exit>
    </object>
    <object name="library35">
      <inherit name="editor_room" />
      <usedefaultprefix />
      <descriptions type="stringdictionary">
        <item>
          <key>darknorth</key>
          <value>You cannot see anything. You feel as if you have faded into the darkness. You can feel a bookshelf in front of you.</value>
        </item>
        <item>
          <key>darkeast</key>
          <value>You cannot see anything. You feel as if you have faded into the darkness. You can feel a small table in front of you.</value>
        </item>
        <item>
          <key>darksouth</key>
          <value>You cannot see anything. You feel as if you have faded into the darkness. You can feel a wall in front of you.</value>
        </item>
        <item>
          <key>darkwest</key>
          <value>You cannot see anything. You feel as if you have faded into the darkness.</value>
        </item>
        <item>
          <key>dimnorth</key>
          <value>There is a bookshelf in front of you. To the east of you there is a small table.</value>
        </item>
        <item>
          <key>dimeast</key>
          <value>There is a small table in front of you. There is a wall to the south of you, and a bookshelf to the east.</value>
        </item>
        <item>
          <key>dimsouth</key>
          <value>There is a wall in front of you, and a small table to the east of you.</value>
        </item>
        <item>
          <key>dimwest</key>
          <value>There is a wall to the south of you, and a bookshelf to the north.</value>
        </item>
        <item>
          <key>brightnorth</key>
          <value>There is a bookshelf in front of you. To the east of you there is a small table. This is a dead end.</value>
        </item>
        <item>
          <key>brighteast</key>
          <value>There is a small table in front of you. There is a wall to the south of you, and a bookshelf to the east. This is a dead end.</value>
        </item>
        <item>
          <key>brightsouth</key>
          <value>There is a wall in front of you, and a small table to the east of you. This is a dead end. </value>
        </item>
        <item>
          <key>brightwest</key>
          <value>There is a wall to the south of you, and a bookshelf to the north. The path continues forwards.</value>
        </item>
      </descriptions>
      <description type="script"><![CDATA[
        PrintRoomDesc (False)
        if (not oil8.parent = null and lantern.light_level > 0) {
          if (player.facing_num = 1) {
            msg ("There is a cask of oil sitting on the table in front of you.")
          }
          else if (player.facing_num <> 3) {
            msg ("There is a cask of oil sitting on the table to the east.")
          }
        }
      ]]></description>
      <exit name="West156" alias="west" to="defaultroom">
        <inherit name="westdirection" />
        <runscript />
        <visible />
        <script type="script">
          MoveAndFace (library33, 3)
        </script>
      </exit>
      <object name="oil8">
        <inherit name="editor_object" />
        <alt type="stringlist">
          <value>cask</value>
        </alt>
        <alias>oil</alias>
        <scenery />
        <feature_usegive />
        <take type="script">
          GetOil (oil8)
        </take>
        <use type="script">
          GetOil (oil8)
        </use>
      </object>
    </object>
    <object name="library36">
      <inherit name="editor_room" />
      <usedefaultprefix />
      <descriptions type="stringdictionary">
        <item>
          <key>darknorth</key>
          <value>You cannot see anything. You feel as if you have faded into the darkness. </value>
        </item>
        <item>
          <key>darkeast</key>
          <value>You cannot see anything. You feel as if you have faded into the darkness.</value>
        </item>
        <item>
          <key>darksouth</key>
          <value>You cannot see anything. You feel as if you have faded into the darkness. You can feel a bookshelf in front of you.</value>
        </item>
        <item>
          <key>darkwest</key>
          <value>You cannot see anything. You feel as if you have faded into the darkness. You can feel a bookshelf in front of you.</value>
        </item>
        <item>
          <key>dimnorth</key>
          <value>There is a bookshelf to the west of you. The path continues forwards, and to the east.</value>
        </item>
        <item>
          <key>dimeast</key>
          <value>There is a bookshelf to the south of you. The path continues forwards, and to the north.</value>
        </item>
        <item>
          <key>dimsouth</key>
          <value>There is a bookshelf in front of you, and a bookshelf to the west of you. The path continues to the east.</value>
        </item>
        <item>
          <key>dimwest</key>
          <value>There is a bookshelf in front of you, and to the south of you. The path continues to the north.</value>
        </item>
        <item>
          <key>brightnorth</key>
          <value>There is a bookshelf to the west of you. The path continues forwards, and to the east.</value>
        </item>
        <item>
          <key>brighteast</key>
          <value>There is a bookshelf to the south of you. The path continues forwards, and to the north.</value>
        </item>
        <item>
          <key>brightsouth</key>
          <value>There is a bookshelf in front of you, and a bookshelf to the west of you. The path continues to the east.</value>
        </item>
        <item>
          <key>brightwest</key>
          <value>There is a bookshelf in front of you, and to the south of you. The path continues to the north. </value>
        </item>
      </descriptions>
      <description type="script">
        PrintRoomDesc (False)
      </description>
      <exit name="East158" alias="east" to="defaultroom">
        <inherit name="eastdirection" />
        <runscript />
        <script type="script">
          MoveAndFace (library47, 1)
        </script>
      </exit>
      <exit name="North170" alias="north" to="defaultroom">
        <inherit name="northdirection" />
        <runscript />
        <script type="script">
          MoveAndFace (library37, 0)
        </script>
      </exit>
    </object>
    <object name="library37">
      <inherit name="editor_room" />
      <usedefaultprefix />
      <descriptions type="stringdictionary">
        <item>
          <key>darknorth</key>
          <value>You cannot see anything. You feel as if you have faded into the darkness. </value>
        </item>
        <item>
          <key>darkeast</key>
          <value>You cannot see anything. You feel as if you have faded into the darkness. You can feel a bookshelf in front of you.</value>
        </item>
        <item>
          <key>darksouth</key>
          <value>You cannot see anything. You feel as if you have faded into the darkness.</value>
        </item>
        <item>
          <key>darkwest</key>
          <value>You cannot see anything. You feel as if you have faded into the darkness. You can feel a bookshelf in front of you.</value>
        </item>
        <item>
          <key>dimnorth</key>
          <value>There is a bookshelf to the east, and west of you. The shelf to the west has a lone black book sitting on it. It doesnt have any writing on it. </value>
        </item>
        <item>
          <key>dimeast</key>
          <value>There is a bookshelf in front of you. </value>
        </item>
        <item>
          <key>dimsouth</key>
          <value>There is a bookshelf to the east, and west of you. The shelf to the west has a single block book sitting on it. It doesnt have any writing on it.</value>
        </item>
        <item>
          <key>dimwest</key>
          <value>There is a bookshelf in front of you, on it there is a single black book. It doesnt have any writing on it.</value>
        </item>
        <item>
          <key>brightnorth</key>
          <value>There is a bookshelf to the east, and west of you. The shelf to the west has a lone black book sitting on it. It doesnt have any writing on it. The path continues forwards.</value>
        </item>
        <item>
          <key>brighteast</key>
          <value>There is a bookshelf in front of you, the path continues in front of you.</value>
        </item>
        <item>
          <key>brightsouth</key>
          <value>There is a bookshelf to the east, and west of you. The shelf to the west has a single block book sitting on it. It doesnt have any writing on it. The path continues forwards.</value>
        </item>
        <item>
          <key>brightwest</key>
          <value>There is a bookshelf in front of you, on it there is a single black book. It doesnt have any writing on it. The path continues to the south, and to the north. </value>
        </item>
      </descriptions>
      <description type="script">
        PrintRoomDesc (False)
      </description>
      <exit name="South172" alias="south" to="defaultroom">
        <inherit name="southdirection" />
        <runscript />
        <script type="script">
          MoveAndFace (library36, 2)
        </script>
      </exit>
      <exit name="North171" alias="north" to="defaultroom">
        <inherit name="northdirection" />
        <runscript />
        <script type="script">
          MoveAndFace (library38, 0)
        </script>
      </exit>
    </object>
    <object name="library38">
      <inherit name="editor_room" />
      <usedefaultprefix />
      <descriptions type="stringdictionary">
        <item>
          <key>darknorth</key>
          <value>You cannot see anything. You feel as if you have faded into the darkness. </value>
        </item>
        <item>
          <key>darkeast</key>
          <value>You cannot see anything. You feel as if you have faded into the darkness.</value>
        </item>
        <item>
          <key>darksouth</key>
          <value>You cannot see anything. You feel as if you have faded into the darkness.</value>
        </item>
        <item>
          <key>darkwest</key>
          <value>You cannot see anything. You feel as if you have faded into the darkness. You can feel a bookshelf in front of you.</value>
        </item>
        <item>
          <key>dimnorth</key>
          <value>There is a bookshelf to the west of you. The path continues to the north, and east of you.</value>
        </item>
        <item>
          <key>dimeast</key>
          <value>You are at a fork in the path. The path continues forwards, to the south, and to the north.</value>
        </item>
        <item>
          <key>dimsouth</key>
          <value>There is a bookshelf to the west of you. The path continues forwards, and to the east of you.</value>
        </item>
        <item>
          <key>dimwest</key>
          <value>There is a bookshelf in front of you. The path continues to the south, and north of you.</value>
        </item>
        <item>
          <key>brightnorth</key>
          <value>There is a bookshelf to the west of you. The path continues to the north, and east of you. </value>
        </item>
        <item>
          <key>brighteast</key>
          <value>You are at a fork in the path. The path continues forwards, to the south, and to the north.</value>
        </item>
        <item>
          <key>brightsouth</key>
          <value>There is a bookshelf to the west of you. The path continues forwards, and to the east of you.</value>
        </item>
        <item>
          <key>brightwest</key>
          <value>There is a bookshelf in front of you. The path continues to the south, and north of you.  </value>
        </item>
      </descriptions>
      <description type="script">
        PrintRoomDesc (False)
      </description>
      <exit name="South173" alias="south" to="defaultroom">
        <inherit name="southdirection" />
        <runscript />
        <script type="script">
          MoveAndFace (library37, 2)
        </script>
      </exit>
      <exit name="East160" alias="east" to="defaultroom">
        <inherit name="eastdirection" />
        <runscript />
        <script type="script">
          MoveAndFace (library48, 1)
        </script>
      </exit>
      <exit name="North172" alias="north" to="defaultroom">
        <inherit name="northdirection" />
        <runscript />
        <script type="script">
          MoveAndFace (library39, 0)
        </script>
      </exit>
    </object>
    <object name="library39">
      <inherit name="editor_room" />
      <usedefaultprefix />
      <descriptions type="stringdictionary">
        <item>
          <key>darknorth</key>
          <value>You cannot see anything. You feel as if you have faded into the darkness. </value>
        </item>
        <item>
          <key>darkeast</key>
          <value>You cannot see anything. You feel as if you have faded into the darkness. You can feel a bookshelf in front of you.</value>
        </item>
        <item>
          <key>darksouth</key>
          <value>You cannot see anything. You feel as if you have faded into the darkness.</value>
        </item>
        <item>
          <key>darkwest</key>
          <value>You cannot see anything. You feel as if you have faded into the darkness. You can feel a bookshelf in front of you.</value>
        </item>
        <item>
          <key>dimnorth</key>
          <value>There is a bookshelf to the west, and the east of you. </value>
        </item>
        <item>
          <key>dimeast</key>
          <value>There is a bookshelf in front of you.</value>
        </item>
        <item>
          <key>dimsouth</key>
          <value>There is a bookshelf to the west, and to the east of you. </value>
        </item>
        <item>
          <key>dimwest</key>
          <value>There is a bookshelf in front of you. </value>
        </item>
        <item>
          <key>brightnorth</key>
          <value>There is a bookshelf to the west, and the east of you. The path continues forwards.</value>
        </item>
        <item>
          <key>brighteast</key>
          <value>There is a bookshelf in front of you. The path continues to the south, and north of you.</value>
        </item>
        <item>
          <key>brightsouth</key>
          <value>There is a bookshelf to the west, and to the east of you. The path continues forwards.</value>
        </item>
        <item>
          <key>brightwest</key>
          <value>There is a bookshelf in front of you. The path continues to the south and north of you.</value>
        </item>
      </descriptions>
      <description type="script">
        PrintRoomDesc (False)
      </description>
      <exit name="South174" alias="south" to="defaultroom">
        <inherit name="southdirection" />
        <runscript />
        <script type="script">
          MoveAndFace (library38, 2)
        </script>
      </exit>
      <exit name="North173" alias="north" to="defaultroom">
        <inherit name="northdirection" />
        <runscript />
        <script type="script">
          MoveAndFace (library40, 0)
        </script>
      </exit>
    </object>
    <object name="library40">
      <inherit name="editor_room" />
      <usedefaultprefix />
      <descriptions type="stringdictionary">
        <item>
          <key>darknorth</key>
          <value>You cannot see anything. You feel as if you have faded into the darkness. </value>
        </item>
        <item>
          <key>darkeast</key>
          <value>You cannot see anything. You feel as if you have faded into the darkness. You can feel a bookshelf in front of you.</value>
        </item>
        <item>
          <key>darksouth</key>
          <value>You cannot see anything. You feel as if you have faded into the darkness.</value>
        </item>
        <item>
          <key>darkwest</key>
          <value>You cannot see anything. You feel as if you have faded into the darkness. You can feel a bookshelf in front of you.</value>
        </item>
        <item>
          <key>dimnorth</key>
          <value>There is a bookshelf to the east, and the west of you. </value>
        </item>
        <item>
          <key>dimeast</key>
          <value>There is a bookshelf in front of you.</value>
        </item>
        <item>
          <key>dimsouth</key>
          <value>There is a bookshelf to the east, and the west of you.</value>
        </item>
        <item>
          <key>dimwest</key>
          <value>There is a bookshelf in front of you. </value>
        </item>
        <item>
          <key>brightnorth</key>
          <value>There is a bookshelf to the east, and the west of you. The path continues forwards.</value>
        </item>
        <item>
          <key>brighteast</key>
          <value>There is a bookshelf in front of you. The path continues to the south, and north of you.</value>
        </item>
        <item>
          <key>brightsouth</key>
          <value>There is a bookshelf to the east, and the west of you. The path continues forwards.</value>
        </item>
        <item>
          <key>brightwest</key>
          <value>There is a bookshelf in front of you. The path continues to the south, and north of you.</value>
        </item>
      </descriptions>
      <description type="script">
        PrintRoomDesc (False)
      </description>
      <exit name="South175" alias="south" to="defaultroom">
        <inherit name="southdirection" />
        <runscript />
        <script type="script">
          MoveAndFace (library39, 2)
        </script>
      </exit>
      <exit name="North174" alias="north" to="defaultroom">
        <inherit name="northdirection" />
        <runscript />
        <script type="script">
          MoveAndFace (library41, 0)
        </script>
      </exit>
    </object>
    <object name="library41">
      <inherit name="editor_room" />
      <usedefaultprefix />
      <descriptions type="stringdictionary">
        <item>
          <key>darknorth</key>
          <value>You cannot see anything. You feel as if you have faded into the darkness. </value>
        </item>
        <item>
          <key>darkeast</key>
          <value>You cannot see anything. You feel as if you have faded into the darkness.</value>
        </item>
        <item>
          <key>darksouth</key>
          <value>You cannot see anything. You feel as if you have faded into the darkness.</value>
        </item>
        <item>
          <key>darkwest</key>
          <value>You cannot see anything. You feel as if you have faded into the darkness. You can feel a bookshelf in front of you.</value>
        </item>
        <item>
          <key>dimnorth</key>
          <value>There is a bookshelf to the west of you. You are in a small. There is something moving around in the middle of the room, it seems to be looking for the source of light.</value>
        </item>
        <item>
          <key>dimeast</key>
          <value>You are in a small room. There is something moving around in the middle of the room, it seems to be looking for the source of light.</value>
        </item>
        <item>
          <key>dimsouth</key>
          <value>There is a bookshelf to the west of you. You are in a small room. The path you are on continues forwards, out of the room. </value>
        </item>
        <item>
          <key>dimwest</key>
          <value>There is a bookshelf in front of you. You are in a small room. The path you are on continues to the south, and the north. </value>
        </item>
        <item>
          <key>brightnorth</key>
          <value>There is a bookshelf to the west of you. You are in a small room. There is something moving around in the middle of the room, it seems to be looking for the source of light. It seems very agitated. </value>
        </item>
        <item>
          <key>brighteast</key>
          <value>You are in a small room surrounded by bookshelfs. There is something moving around in the middle of the room, it seems to be looking for the source of light. It seems very agitated.</value>
        </item>
        <item>
          <key>brightsouth</key>
          <value>There is a bookshelf to the west of you. You are in a small room. The path you are on continues forwards, out of the room. </value>
        </item>
        <item>
          <key>brightwest</key>
          <value>There is a bookshelf in front of you. You are in a small room. The path you are on continues to the south, the east and the north. To the south is an exit to the small room.</value>
        </item>
      </descriptions>
      <description type="script">
        PrintRoomDesc (False)
      </description>
      <exit name="South176" alias="south" to="defaultroom">
        <inherit name="southdirection" />
        <runscript />
        <script type="script">
          MoveAndFace (library40, 2)
        </script>
      </exit>
      <exit name="East163" alias="east" to="defaultroom">
        <inherit name="eastdirection" />
        <runscript />
        <script type="script">
          MoveAndFace (library49, 1)
        </script>
      </exit>
      <exit name="North175" alias="north" to="defaultroom">
        <inherit name="northdirection" />
        <runscript />
        <script type="script">
          MoveAndFace (library42, 0)
        </script>
      </exit>
    </object>
    <object name="library42">
      <inherit name="editor_room" />
      <usedefaultprefix />
      <descriptions type="stringdictionary">
        <item>
          <key>darknorth</key>
          <value>You cannot see anything. You feel as if you have faded into the darkness. </value>
        </item>
        <item>
          <key>darkeast</key>
          <value>You cannot see anything. You feel as if you have faded into the darkness.</value>
        </item>
        <item>
          <key>darksouth</key>
          <value>You cannot see anything. You feel as if you have faded into the darkness.</value>
        </item>
        <item>
          <key>darkwest</key>
          <value>You cannot see anything. You feel as if you have faded into the darkness.</value>
        </item>
        <item>
          <key>dimnorth</key>
          <value>You are in a small room. There is something moving around a few steps east of you. It sounds irritated, and seems to be looking for the source of the light. </value>
        </item>
        <item>
          <key>dimeast</key>
          <value>You are in a small room. There is something moving a few steps forwards. It sounds irritated, and seems to be looking for the source of the light. </value>
        </item>
        <item>
          <key>dimsouth</key>
          <value>You are in a small room. There is something moving a few steps east. It sounds irritated, and seems to be looking for the source of the light. </value>
        </item>
        <item>
          <key>dimwest</key>
          <value>You are in a small room. The path you are on leads forwards, to the south, and the north. </value>
        </item>
        <item>
          <key>brightnorth</key>
          <value>You are in a small room. There is something moving a few steps east of you. It sounds irritated, and seems to be looking for the source of the light. You shouldnt get too close. </value>
        </item>
        <item>
          <key>brighteast</key>
          <value>You are in a small room. There is something moving a few steps forwards. It sounds irritated, and seems to be looking for the source of the light. You shouldnt get too close.</value>
        </item>
        <item>
          <key>brightsouth</key>
          <value>You are in a small room. There is something moving a few east. It sounds irritated, and seems to be looking for the source of the light. You shouldnt get too close.</value>
        </item>
        <item>
          <key>brightwest</key>
          <value>You are in a small room. The path you are on leads forwards, to the south, and the north. The path to the south leads out of the room. </value>
        </item>
      </descriptions>
      <description type="script">
        PrintRoomDesc (False)
      </description>
      <exit name="West163" alias="west" to="defaultroom">
        <inherit name="westdirection" />
        <runscript />
        <visible />
        <script type="script">
          MoveAndFace (library34, 3)
        </script>
      </exit>
      <exit name="South177" alias="south" to="defaultroom">
        <inherit name="southdirection" />
        <runscript />
        <script type="script">
          MoveAndFace (library41, 2)
        </script>
      </exit>
      <exit name="East164" alias="east" to="defaultroom">
        <inherit name="eastdirection" />
        <runscript />
        <script type="script">
          MoveAndFace (library50, 1)
        </script>
      </exit>
      <exit name="North176" alias="north" to="defaultroom">
        <inherit name="northdirection" />
        <runscript />
        <script type="script">
          MoveAndFace (library43, 0)
        </script>
      </exit>
    </object>
    <object name="library43">
      <inherit name="editor_room" />
      <usedefaultprefix />
      <descriptions type="stringdictionary">
        <item>
          <key>darknorth</key>
          <value>You cannot see anything. You feel as if you have faded into the darkness. </value>
        </item>
        <item>
          <key>darkeast</key>
          <value>You cannot see anything. You feel as if you have faded into the darkness.</value>
        </item>
        <item>
          <key>darksouth</key>
          <value>You cannot see anything. You feel as if you have faded into the darkness.</value>
        </item>
        <item>
          <key>darkwest</key>
          <value>You cannot see anything. You feel as if you have faded into the darkness. You can feel a bookshelf in front of you.</value>
        </item>
        <item>
          <key>dimnorth</key>
          <value>There is a bookshelf to the west of you. You are in a small room.</value>
        </item>
        <item>
          <key>dimeast</key>
          <value>You are in a small room. You can see something moving in the middle of the room. You cant tell what it is, but it looks humanoid. It seems irritated and is looking around for the source of light.</value>
        </item>
        <item>
          <key>dimsouth</key>
          <value>There is a bookshelf to the west of you. You are in a small room. You can see something moving in the middle of the room. You cant tell what it is, but it looks humanoid. It seems irritated and is looking around for the source of light.</value>
        </item>
        <item>
          <key>dimwest</key>
          <value>There is a bookshelf in front of you. </value>
        </item>
        <item>
          <key>brightnorth</key>
          <value>There is a bookshelf to the west of you. You are in a small room.</value>
        </item>
        <item>
          <key>brighteast</key>
          <value>You are in a small room. You can see something moving in the middle of the room. You cant tell what it is, but it looks humanoid. It seems irritated and is looking around for the source of light.</value>
        </item>
        <item>
          <key>brightsouth</key>
          <value>There is a bookshelf to the west of you. You are in a small room. You can see something moving in the middle of the room. You cant tell what it is, but it looks humanoid. It seems irritated and is looking around for the source of light.</value>
        </item>
        <item>
          <key>brightwest</key>
          <value>There is a bookshelf in front of you.</value>
        </item>
      </descriptions>
      <description type="script">
        PrintRoomDesc (False)
      </description>
      <exit name="South178" alias="south" to="defaultroom">
        <inherit name="southdirection" />
        <runscript />
        <script type="script">
          MoveAndFace (library42, 2)
        </script>
      </exit>
      <exit name="East165" alias="east" to="defaultroom">
        <inherit name="eastdirection" />
        <runscript />
        <script type="script">
          MoveAndFace (library51, 1)
        </script>
      </exit>
      <exit name="North177" alias="north" to="defaultroom">
        <inherit name="northdirection" />
        <runscript />
        <script type="script">
          MoveAndFace (library44, 0)
        </script>
      </exit>
    </object>
    <object name="library44">
      <inherit name="editor_room" />
      <usedefaultprefix />
      <descriptions type="stringdictionary">
        <item>
          <key>darknorth</key>
          <value>You cannot see anything. You feel as if you have faded into the darkness. You can feel a bookshelf in front of you.</value>
        </item>
        <item>
          <key>darkeast</key>
          <value>You cannot see anything. You feel as if you have faded into the darkness.</value>
        </item>
        <item>
          <key>darksouth</key>
          <value>You cannot see anything. You feel as if you have faded into the darkness.</value>
        </item>
        <item>
          <key>darkwest</key>
          <value>You cannot see anything. You feel as if you have faded into the darkness. You can feel a bookshelf in front of you.</value>
        </item>
        <item>
          <key>dimnorth</key>
          <value>There is a bookshelf in front of you, and to the west of you. You are in a corner of the small room.</value>
        </item>
        <item>
          <key>dimeast</key>
          <value>There is a bookshelf to the north of you. You are in a small room. There is something moving in the middle of the room. It is grunting, and sounds angry. It seems to be searching for the source of the light.</value>
        </item>
        <item>
          <key>dimsouth</key>
          <value>There is a bookshelf to the west of you. You are in a small room. There is something moving in the middle of the room. It is grunting, and sounds angry. It seems to be searching for the source of the light.</value>
        </item>
        <item>
          <key>dimwest</key>
          <value>There is a bookshelf in front of you, and to the north of you. You are in the corner of a small room.</value>
        </item>
        <item>
          <key>brightnorth</key>
          <value>There is a bookshelf in front of you, and to the west of you. You are in a corner of the small room.</value>
        </item>
        <item>
          <key>brighteast</key>
          <value>There is a bookshelf to the north of you. You are in a small room. There is something moving in the middle of the room. It is grunting, and sounds angry. It seems to be searching for the source of the light.</value>
        </item>
        <item>
          <key>brightsouth</key>
          <value>There is a bookshelf to the west of you. You are in a small room. There is something moving in the middle of the room. It is grunting, and sounds angry. It seems to be searching for the source of the light.  </value>
        </item>
        <item>
          <key>brightwest</key>
          <value>There is a bookshelf in front of you, and to the north of you. You are in the corner of a small room.</value>
        </item>
      </descriptions>
      <description type="script">
        PrintRoomDesc (False)
      </description>
      <exit name="South179" alias="south" to="defaultroom">
        <inherit name="southdirection" />
        <runscript />
        <script type="script">
          MoveAndFace (library43, 2)
        </script>
      </exit>
      <exit name="East166" alias="east" to="defaultroom">
        <inherit name="eastdirection" />
        <runscript />
        <script type="script">
          MoveAndFace (library52, 1)
        </script>
      </exit>
    </object>
    <object name="library45">
      <inherit name="editor_room" />
      <usedefaultprefix />
      <descriptions type="stringdictionary">
        <item>
          <key>darknorth</key>
          <value>You cannot see anything. You feel as if you have faded into the darkness. You can feel a bookshelf in front of you.</value>
        </item>
        <item>
          <key>darkeast</key>
          <value>You cannot see anything. You feel as if you have faded into the darkness.</value>
        </item>
        <item>
          <key>darksouth</key>
          <value>You cannot see anything. You feel as if you have faded into the darkness. You can feel a bookshelf in front of you.</value>
        </item>
        <item>
          <key>darkwest</key>
          <value>You cannot see anything. You feel as if you have faded into the darkness. You can feel a bookshelf in front of you.</value>
        </item>
        <item>
          <key>dimnorth</key>
          <value>There is a bookshelf in front of you, and to the west of you. This seems to be a dead end.</value>
        </item>
        <item>
          <key>dimeast</key>
          <value>There is a bookshelf to the south, and north of you. The path continues in front of you.</value>
        </item>
        <item>
          <key>dimsouth</key>
          <value>There is a bookshelf in front of you, and to the west of you. This seems to be a dead end. </value>
        </item>
        <item>
          <key>dimwest</key>
          <value>There is a bookshelf in front of you, to the south of you, and the north of you. This seems to be a dead end.</value>
        </item>
        <item>
          <key>brightnorth</key>
          <value>There is a bookshelf in front of you, and to the west of you. This seems to be a dead end. The path continues to the east of you. </value>
        </item>
        <item>
          <key>brighteast</key>
          <value>The bright light hurts your eyes. There is a bookshelf to the south, and north of you. The path continues in front of you. </value>
        </item>
        <item>
          <key>brightsouth</key>
          <value>The bright light hurts your eyes. There is a bookshelf in front of you, and to the west of you. This seems to be a dead end. The path continues to the east.</value>
        </item>
        <item>
          <key>brightwest</key>
          <value>The bright light hurts your eyes. There is a bookshelf in front of you, to the south of you, and the north of you. This seems to be a dead end. </value>
        </item>
      </descriptions>
      <description type="script">
        PrintRoomDesc (False)
      </description>
      <exit name="East167" alias="east" to="defaultroom">
        <inherit name="eastdirection" />
        <runscript />
        <script type="script">
          MoveAndFace (library54, 1)
        </script>
      </exit>
    </object>
    <object name="library47">
      <inherit name="editor_room" />
      <usedefaultprefix />
      <descriptions type="stringdictionary">
        <item>
          <key>darknorth</key>
          <value>You cannot see anything. You feel as if you have faded into the darkness. You can feel a bookshelf in front of you.</value>
        </item>
        <item>
          <key>darkeast</key>
          <value>You cannot see anything. You feel as if you have faded into the darkness.</value>
        </item>
        <item>
          <key>darksouth</key>
          <value>You cannot see anything. You feel as if you have faded into the darkness. You can feel a bookshelf in front of you.</value>
        </item>
        <item>
          <key>darkwest</key>
          <value>You cannot see anything. You feel as if you have faded into the darkness.</value>
        </item>
        <item>
          <key>dimnorth</key>
          <value>There is a bookshelf in front of you.</value>
        </item>
        <item>
          <key>dimeast</key>
          <value>There is a bookshelf to the south, and north of you. </value>
        </item>
        <item>
          <key>dimsouth</key>
          <value>There is a bookshelf in front of you.</value>
        </item>
        <item>
          <key>dimwest</key>
          <value>There is a bookshelf to the south, and north of you.</value>
        </item>
        <item>
          <key>brightnorth</key>
          <value>There is a bookshelf in front of you. The path continues to the east, and the west of you. </value>
        </item>
        <item>
          <key>brighteast</key>
          <value>There is a bookshelf to the south, and north of you. The path continues forwards.</value>
        </item>
        <item>
          <key>brightsouth</key>
          <value>There is a bookshelf in front of you. The path continues to the east, and the west of you.</value>
        </item>
        <item>
          <key>brightwest</key>
          <value>There is a bookshelf to the south, and north of you. The path continues forwards.</value>
        </item>
      </descriptions>
      <description type="script">
        PrintRoomDesc (False)
      </description>
      <exit name="West168" alias="west" to="defaultroom">
        <inherit name="westdirection" />
        <runscript />
        <visible />
        <script type="script">
          MoveAndFace (library36, 3)
        </script>
      </exit>
      <exit name="East169" alias="east" to="defaultroom">
        <inherit name="eastdirection" />
        <runscript />
        <script type="script">
          MoveAndFace (library55, 1)
        </script>
      </exit>
    </object>
    <object name="library48">
      <inherit name="editor_room" />
      <usedefaultprefix />
      <descriptions type="stringdictionary">
        <item>
          <key>darknorth</key>
          <value>You cannot see anything. You feel as if you have faded into the darkness. You can feel a bookshelf in front of you.</value>
        </item>
        <item>
          <key>darkeast</key>
          <value>You cannot see anything. You feel as if you have faded into the darkness.</value>
        </item>
        <item>
          <key>darksouth</key>
          <value>You cannot see anything. You feel as if you have faded into the darkness. You can feel a bookshelf in front of you.</value>
        </item>
        <item>
          <key>darkwest</key>
          <value>You cannot see anything. You feel as if you have faded into the darkness.</value>
        </item>
        <item>
          <key>dimnorth</key>
          <value>There is a bookshelf in front of you. </value>
        </item>
        <item>
          <key>dimeast</key>
          <value>There is a bookshelf to the south, and to the north of you.</value>
        </item>
        <item>
          <key>dimsouth</key>
          <value>There is a bookshelf in front of you.</value>
        </item>
        <item>
          <key>dimwest</key>
          <value>There is a bookshelf to the south, and north of you. </value>
        </item>
        <item>
          <key>brightnorth</key>
          <value>There is a bookshelf in front of you. The path continues to the east, and west of you.</value>
        </item>
        <item>
          <key>brighteast</key>
          <value>There is a bookshelf to the south, and to the north of you. The path continues forwards.</value>
        </item>
        <item>
          <key>brightsouth</key>
          <value>There is a bookshelf in front of you. The path continues to the east, and west of you.</value>
        </item>
        <item>
          <key>brightwest</key>
          <value>There is a bookshelf to the south, and north of you. The path continues forwards.</value>
        </item>
      </descriptions>
      <description type="script">
        PrintRoomDesc (False)
      </description>
      <exit name="West169" alias="west" to="defaultroom">
        <inherit name="westdirection" />
        <runscript />
        <visible />
        <script type="script">
          MoveAndFace (library38, 3)
        </script>
      </exit>
      <exit name="East170" alias="east" to="defaultroom">
        <inherit name="eastdirection" />
        <runscript />
        <script type="script">
          MoveAndFace (library56, 1)
        </script>
      </exit>
    </object>
    <object name="library49">
      <inherit name="editor_room" />
      <usedefaultprefix />
      <descriptions type="stringdictionary">
        <item>
          <key>darknorth</key>
          <value>You cannot see anything. You feel as if you have faded into the darkness. You can feel the shelving to the south of you.</value>
        </item>
        <item>
          <key>darkeast</key>
          <value>You cannot see anything. You feel as if you have faded into the darkness.</value>
        </item>
        <item>
          <key>darksouth</key>
          <value>You cannot see anything. You feel as if you have faded into the darkness. You can feel a bookshelf in front of you.</value>
        </item>
        <item>
          <key>darkwest</key>
          <value>You cannot see anything. You feel as if you have faded into the darkness. You can feel the shelving to the south of you.</value>
        </item>
        <item>
          <key>dimnorth</key>
          <value>You are in a small room. There is something moving to the northeast of you. It is a tall shadowy figure, it is grunting angrily, and seems to be looking for the source of the light.</value>
        </item>
        <item>
          <key>dimeast</key>
          <value>You are in a small room. There is something moving to the northeast of you. It is a tall shadowy figure, it is grunting angrily, and seems to be looking for the source of the light. </value>
        </item>
        <item>
          <key>dimsouth</key>
          <value>There is a bookshelf in front of you. You are in a small room.</value>
        </item>
        <item>
          <key>dimwest</key>
          <value>There is a bookshelf to the south of you. You are in a small room.</value>
        </item>
        <item>
          <key>brightnorth</key>
          <value>You are in a small room. There is something moving to the northeast of you. It is a tall shadowy figure, it is grunting angrily, and seems to be looking for the source of the light. You shouldnt get too close. </value>
        </item>
        <item>
          <key>brighteast</key>
          <value>You are in a small room. There is something moving to the northeast of you. It is a tall shadowy figure, it is grunting angrily, and seems to be looking for the source of the light. You shouldnt get too close. </value>
        </item>
        <item>
          <key>brightsouth</key>
          <value>There is a bookshelf in front of you. You are in a small room. Southwest of you is an exit to the room.</value>
        </item>
        <item>
          <key>brightwest</key>
          <value>There is a bookshelf to the south of you. You are in a small room. Southwest of you is an exit to the room. </value>
        </item>
      </descriptions>
      <description type="script">
        PrintRoomDesc (False)
      </description>
      <exit name="West170" alias="west" to="defaultroom">
        <inherit name="westdirection" />
        <runscript />
        <visible />
        <script type="script">
          MoveAndFace (library41, 3)
        </script>
      </exit>
      <exit name="East171" alias="east" to="defaultroom">
        <inherit name="eastdirection" />
        <runscript />
        <script type="script">
          MoveAndFace (library57, 1)
        </script>
      </exit>
      <exit name="North183" alias="north" to="defaultroom">
        <inherit name="northdirection" />
        <runscript />
        <script type="script">
          MoveAndFace (library50, 0)
        </script>
      </exit>
    </object>
    <object name="library50">
      <inherit name="editor_room" />
      <usedefaultprefix />
      <descriptions type="stringdictionary">
        <item>
          <key>darknorth</key>
          <value>TODO: implement this description</value>
        </item>
        <item>
          <key>darkeast</key>
          <value>TODO: implement this description</value>
        </item>
        <item>
          <key>darksouth</key>
          <value>TODO: implement this description</value>
        </item>
        <item>
          <key>darkwest</key>
          <value>TODO: implement this description</value>
        </item>
        <item>
          <key>dimnorth</key>
          <value>TODO: implement this description</value>
        </item>
        <item>
          <key>dimeast</key>
          <value>TODO: implement this description</value>
        </item>
        <item>
          <key>dimsouth</key>
          <value>TODO: implement this description</value>
        </item>
        <item>
          <key>dimwest</key>
          <value>TODO: implement this description</value>
        </item>
        <item>
          <key>brightnorth</key>
          <value>TODO: implement this description</value>
        </item>
        <item>
          <key>brighteast</key>
          <value>TODO: implement this description</value>
        </item>
        <item>
          <key>brightsouth</key>
          <value>TODO: implement this description</value>
        </item>
        <item>
          <key>brightwest</key>
          <value>TODO: implement this description</value>
        </item>
      </descriptions>
      <description type="script">
        msg ("The tall creature looks at you, and snarls. He is towering over you, and you can feel his breath on your face. He brings his face as close to yours as possible, and roars louder than you have ever heard before. You are disoriented, and deaf. You can feel warm blood run down the sides of your face from your ears. You start getting dizzy, but before you can faint the creature raises a fist and...")
        Die
      </description>
      <exit name="West171" alias="west" to="defaultroom">
        <inherit name="westdirection" />
        <runscript />
        <visible />
        <script type="script">
          MoveAndFace (library42, 3)
        </script>
      </exit>
      <exit name="South185" alias="south" to="defaultroom">
        <inherit name="southdirection" />
        <runscript />
        <script type="script">
          MoveAndFace (library49, 2)
        </script>
      </exit>
      <exit name="North184" alias="north" to="defaultroom">
        <inherit name="northdirection" />
        <runscript />
        <script type="script">
          MoveAndFace (library51, 0)
        </script>
      </exit>
    </object>
    <object name="library51">
      <inherit name="editor_room" />
      <usedefaultprefix />
      <descriptions type="stringdictionary">
        <item>
          <key>darknorth</key>
          <value>You cannot see anything. You feel as if you have faded into the darkness. You cannot feel anything around you, and assume youre in the middle of the room.</value>
        </item>
        <item>
          <key>darkeast</key>
          <value>You cannot see anything. You feel as if you have faded into the darkness. You cannot feel anything around you. </value>
        </item>
        <item>
          <key>darksouth</key>
          <value>You cannot see anything. You feel as if you have faded into the darkness. You cannot feel anything around you. </value>
        </item>
        <item>
          <key>darkwest</key>
          <value>You cannot see anything. You feel as if you have faded into the darkness.</value>
        </item>
        <item>
          <key>dimnorth</key>
          <value>There is not much around you, you are in a small room. You can hear angry noises from the creature behind you.</value>
        </item>
        <item>
          <key>dimeast</key>
          <value>There is not much around you. The angry, shadowy creature is directly to the southeast of you. He is growling at the lantern in your hand.</value>
        </item>
        <item>
          <key>dimsouth</key>
          <value>There is not much around you. The angry, shadowy creature is directly to the southeast of you. He is growling at the lantern in your hand.</value>
        </item>
        <item>
          <key>dimwest</key>
          <value>There is not much around you. You can hear angry grunting coming from behind you.</value>
        </item>
        <item>
          <key>brightnorth</key>
          <value>There is not much around you, you are in a small room. You can hear angry noises from the creature behind you. A few steps forwards is an exit to the room. </value>
        </item>
        <item>
          <key>brighteast</key>
          <value>There is not much around you. The angry, shadowy creature is directly to the southeast of you. He is growling at the lantern in your hand. You think he might charge at you.</value>
        </item>
        <item>
          <key>brightsouth</key>
          <value>There is not much around you. The angry, shadowy creature is directly to the southeast of you. He is growling at the lantern in your hand. You think he might charge at you.</value>
        </item>
        <item>
          <key>brightwest</key>
          <value>There is not much around you. You can hear angry grunting coming from behind you.</value>
        </item>
      </descriptions>
      <description type="script">
        PrintRoomDesc (False)
      </description>
      <exit name="West172" alias="west" to="defaultroom">
        <inherit name="westdirection" />
        <runscript />
        <visible />
        <script type="script">
          MoveAndFace (library43, 3)
        </script>
      </exit>
      <exit name="South186" alias="south" to="defaultroom">
        <inherit name="southdirection" />
        <runscript />
        <script type="script">
          MoveAndFace (library50, 2)
        </script>
      </exit>
      <exit name="East173" alias="east" to="defaultroom">
        <inherit name="eastdirection" />
        <runscript />
        <script type="script">
          MoveAndFace (library58, 1)
        </script>
      </exit>
      <exit name="North185" alias="north" to="defaultroom">
        <inherit name="northdirection" />
        <runscript />
        <script type="script">
          MoveAndFace (library52, 0)
        </script>
      </exit>
    </object>
    <object name="library52">
      <inherit name="editor_room" />
      <usedefaultprefix />
      <descriptions type="stringdictionary">
        <item>
          <key>darknorth</key>
          <value>You cannot see anything. You feel as if you have faded into the darkness. You can feel a space between two bookshelves that can get you out of this room a step forwards. </value>
        </item>
        <item>
          <key>darkeast</key>
          <value>You cannot see anything. You feel as if you have faded into the darkness. You cannot feel anything around you.</value>
        </item>
        <item>
          <key>darksouth</key>
          <value>You cannot see anything. You feel as if you have faded into the darkness. You cannot feel anything around. </value>
        </item>
        <item>
          <key>darkwest</key>
          <value>You cannot see anything. You feel as if you have faded into the darkness.</value>
        </item>
        <item>
          <key>dimnorth</key>
          <value>There is not much around you. A step forwards is an exit out of the small room. You can hear noises coming from a ways behind you.</value>
        </item>
        <item>
          <key>dimeast</key>
          <value>There is not much around you. You are in a small room. To the north of you is an exit out of this room. There is a figure in the middle of the room, to the southeast of you. It is angrily grunting, and seems to be searching for the source of the light. </value>
        </item>
        <item>
          <key>dimsouth</key>
          <value>There is not much around you. You are in a small room. There is a figure in the middle of the room, to the southeast of you. It is angrily grunting, and seems to be searching for the source of the light. </value>
        </item>
        <item>
          <key>dimwest</key>
          <value>There is not much around you. You are in a small room. To the north of you is an exit out of this room. There is a figure in the middle of the room, to the southeast of you. It is angrily grunting, and seems to be searching for the source of the light. </value>
        </item>
        <item>
          <key>brightnorth</key>
          <value>There is not much around you. A step forwards is an exit out of the small room. You can hear noises coming from a ways behind you.</value>
        </item>
        <item>
          <key>brighteast</key>
          <value>There is not much around you. You are in a small room. To the north of you is an exit out of this room. There is a figure in the middle of the room, to the southeast of you. It is angrily grunting, and seems to be searching for the source of the light. </value>
        </item>
        <item>
          <key>brightsouth</key>
          <value>There is not much around you. You are in a small room. There is a figure in the middle of the room, to the southeast of you. It is angrily grunting, and seems to be searching for the source of the light. </value>
        </item>
        <item>
          <key>brightwest</key>
          <value>There is not much around you. You are in a small room. To the north of you is an exit out of this room. There is a figure in the middle of the room, to the southeast of you. It is angrily grunting, and seems to be searching for the source of the light. </value>
        </item>
      </descriptions>
      <description type="script">
        PrintRoomDesc (False)
      </description>
      <exit name="West173" alias="west" to="defaultroom">
        <inherit name="westdirection" />
        <runscript />
        <visible />
        <script type="script">
          MoveAndFace (library44, 3)
        </script>
      </exit>
      <exit name="South187" alias="south" to="defaultroom">
        <inherit name="southdirection" />
        <runscript />
        <script type="script">
          MoveAndFace (library51, 2)
        </script>
      </exit>
      <exit name="East174" alias="east" to="defaultroom">
        <inherit name="eastdirection" />
        <runscript />
        <script type="script">
          MoveAndFace (library59, 1)
        </script>
      </exit>
      <exit name="North186" alias="north" to="defaultroom">
        <inherit name="northdirection" />
        <runscript />
        <script type="script">
          MoveAndFace (library53, 0)
        </script>
      </exit>
    </object>
    <object name="library53">
      <inherit name="editor_room" />
      <usedefaultprefix />
      <descriptions type="stringdictionary">
        <item>
          <key>darknorth</key>
          <value>You cannot see anything. You feel as if you have faded into the darkness. You can feel bookshelves to the east and west of you.</value>
        </item>
        <item>
          <key>darkeast</key>
          <value>You cannot see anything. You feel as if you have faded into the darkness. You can feel a bookshelf in front of you.</value>
        </item>
        <item>
          <key>darksouth</key>
          <value>You cannot see anything. You feel as if you have faded into the darkness. You can feel bookshelves to the east, and the west of you. </value>
        </item>
        <item>
          <key>darkwest</key>
          <value>You cannot see anything. You feel as if you have faded into the darkness. You can feel a bookshelf in front of you.</value>
        </item>
        <item>
          <key>dimnorth</key>
          <value>There is a bookshelf to the east, and the west of you. </value>
        </item>
        <item>
          <key>dimeast</key>
          <value>There is a bookshelf in front of you. There is a small room to the south of you.</value>
        </item>
        <item>
          <key>dimsouth</key>
          <value>There is a bookshelf to the east, and to the west of you. There is a small room ahead.</value>
        </item>
        <item>
          <key>dimwest</key>
          <value>There is a bookshelf in front of you. There is a small room to the south of you.</value>
        </item>
        <item>
          <key>brightnorth</key>
          <value>There is a bookshelf to the east, and the west of you. The path continues forwards.</value>
        </item>
        <item>
          <key>brighteast</key>
          <value>There is a bookshelf in front of you. There is a small room to the south of you. The path continues to the north of you.</value>
        </item>
        <item>
          <key>brightsouth</key>
          <value>There is a bookshelf to the east, and to the west of you. There is a small room ahead.</value>
        </item>
        <item>
          <key>brightwest</key>
          <value>There is a bookshelf in front of you. There is a small room to the south of you. The path continues north.</value>
        </item>
      </descriptions>
      <description type="script">
        PrintRoomDesc (False)
      </description>
      <exit name="South188" alias="south" to="defaultroom">
        <inherit name="southdirection" />
        <runscript />
        <script type="script">
          MoveAndFace (library52, 2)
        </script>
      </exit>
      <exit name="North187" alias="north" to="defaultroom">
        <inherit name="northdirection" />
        <runscript />
        <script type="script">
          MoveAndFace (library54, 0)
        </script>
      </exit>
    </object>
    <object name="library54">
      <inherit name="editor_room" />
      <usedefaultprefix />
      <descriptions type="stringdictionary">
        <item>
          <key>darknorth</key>
          <value>You cannot see anything. You feel as if you have faded into the darkness. You can feel a bookshelf in front of you.</value>
        </item>
        <item>
          <key>darkeast</key>
          <value>You cannot see anything. You feel as if you have faded into the darkness. You can feel a bookshelf to the north of you.</value>
        </item>
        <item>
          <key>darksouth</key>
          <value>You cannot see anything. You feel as if you have faded into the darkness.</value>
        </item>
        <item>
          <key>darkwest</key>
          <value>You cannot see anything. You feel as if you have faded into the darkness. You can feel a bookshelf to the north of you.</value>
        </item>
        <item>
          <key>dimnorth</key>
          <value>There is a bookshelf in front of you. </value>
        </item>
        <item>
          <key>dimeast</key>
          <value>There is a bookshelf to the north of you.</value>
        </item>
        <item>
          <key>dimsouth</key>
          <value>You are at a fork in the path. The path continues forwards, to the west, and to the east. There seems be a small room up ahead.</value>
        </item>
        <item>
          <key>dimwest</key>
          <value>There is a bookshelf to the north of you. </value>
        </item>
        <item>
          <key>brightnorth</key>
          <value>The bright light hurts your eyes. There is a bookshelf in front of you. The path continues to the west, and east of you. </value>
        </item>
        <item>
          <key>brighteast</key>
          <value>The bright light hurts your eyes. There is a bookshelf to the north of you. The path continues to the east. </value>
        </item>
        <item>
          <key>brightsouth</key>
          <value>The bright light burns your eyes. You are at a fork in the path. The path continues forwards, to the west, and to the east. There seems be a small room up ahead.</value>
        </item>
        <item>
          <key>brightwest</key>
          <value>There is a bookshelf to the north of you. The path continues to the south of you. </value>
        </item>
      </descriptions>
      <description type="script">
        PrintRoomDesc (False)
      </description>
      <exit name="West175" alias="west" to="defaultroom">
        <inherit name="westdirection" />
        <runscript />
        <visible />
        <script type="script">
          MoveAndFace (library45, 3)
        </script>
      </exit>
      <exit name="South189" alias="south" to="defaultroom">
        <inherit name="southdirection" />
        <runscript />
        <script type="script">
          MoveAndFace (library53, 2)
        </script>
      </exit>
      <exit name="East176" alias="east" to="defaultroom">
        <inherit name="eastdirection" />
        <runscript />
        <script type="script">
          MoveAndFace (library60, 1)
        </script>
      </exit>
    </object>
    <object name="library55">
      <inherit name="editor_room" />
      <usedefaultprefix />
      <descriptions type="stringdictionary">
        <item>
          <key>darknorth</key>
          <value>You cannot see anything. You feel as if you have faded into the darkness. You can feel a bookshelf in front of you.</value>
        </item>
        <item>
          <key>darkeast</key>
          <value>You cannot see anything. You feel as if you have faded into the darkness.</value>
        </item>
        <item>
          <key>darksouth</key>
          <value>You cannot see anything. You feel as if you have faded into the darkness. You can feel a bookshelf in front of you.</value>
        </item>
        <item>
          <key>darkwest</key>
          <value>You cannot see anything. You feel as if you have faded into the darkness.</value>
        </item>
        <item>
          <key>dimnorth</key>
          <value>There is a bookshelf in front of you. </value>
        </item>
        <item>
          <key>dimeast</key>
          <value>There is a bookshelf to the north, and south of you.</value>
        </item>
        <item>
          <key>dimsouth</key>
          <value>There is a bookshelf in front of you. </value>
        </item>
        <item>
          <key>dimwest</key>
          <value>There is a bookshelf to the south, and north of you.</value>
        </item>
        <item>
          <key>brightnorth</key>
          <value>There is a bookshelf in front of you. The path continues to the east and west of you.</value>
        </item>
        <item>
          <key>brighteast</key>
          <value>There is a bookshelf to the north, and south of you. The path continues forwards. </value>
        </item>
        <item>
          <key>brightsouth</key>
          <value>There is a bookshelf in front of you. The path continues to the east and west. </value>
        </item>
        <item>
          <key>brightwest</key>
          <value>There is a bookshelf to the south, and north of you. The path continues forwards.</value>
        </item>
      </descriptions>
      <description type="script">
        PrintRoomDesc (False)
      </description>
      <exit name="West176" alias="west" to="defaultroom">
        <inherit name="westdirection" />
        <runscript />
        <visible />
        <script type="script">
          MoveAndFace (library47, 3)
        </script>
      </exit>
      <exit name="East177" alias="east" to="defaultroom">
        <inherit name="eastdirection" />
        <runscript />
        <script type="script">
          MoveAndFace (library63, 1)
        </script>
      </exit>
    </object>
    <object name="library56">
      <inherit name="editor_room" />
      <usedefaultprefix />
      <descriptions type="stringdictionary">
        <item>
          <key>darknorth</key>
          <value>You cannot see anything. You feel as if you have faded into the darkness. You can feel a bookshelf in front of you.</value>
        </item>
        <item>
          <key>darkeast</key>
          <value>You cannot see anything. You feel as if you have faded into the darkness.</value>
        </item>
        <item>
          <key>darksouth</key>
          <value>You cannot see anything. You feel as if you have faded into the darkness. You can feel a bookshelf in front of you.</value>
        </item>
        <item>
          <key>darkwest</key>
          <value>You cannot see anything. You feel as if you have faded into the darkness.</value>
        </item>
        <item>
          <key>dimnorth</key>
          <value>There is a bookshelf in front of you. </value>
        </item>
        <item>
          <key>dimeast</key>
          <value>There is a bookshelf to the south, and to the north of you. </value>
        </item>
        <item>
          <key>dimsouth</key>
          <value>There is a bookshelf in front of you.</value>
        </item>
        <item>
          <key>dimwest</key>
          <value>There is a bookshelf to the south, and to the north of you.</value>
        </item>
        <item>
          <key>brightnorth</key>
          <value>There is a bookshelf in front of you. The path continues to the east, and to the west.</value>
        </item>
        <item>
          <key>brighteast</key>
          <value>There is a bookshelf to the south, and to the north of you. The path continues forwards.</value>
        </item>
        <item>
          <key>brightsouth</key>
          <value>There is a bookshelf in front of you. The path continues to the east, and to the west.</value>
        </item>
        <item>
          <key>brightwest</key>
          <value>There is a bookshelf to the south, and to the north of you. The path continues forwards.</value>
        </item>
      </descriptions>
      <description type="script">
        PrintRoomDesc (False)
      </description>
      <exit name="West177" alias="west" to="defaultroom">
        <inherit name="westdirection" />
        <runscript />
        <visible />
        <script type="script">
          MoveAndFace (library48, 3)
        </script>
      </exit>
      <exit name="East178" alias="east" to="defaultroom">
        <inherit name="eastdirection" />
        <runscript />
        <script type="script">
          MoveAndFace (library64, 1)
        </script>
      </exit>
    </object>
    <object name="library57">
      <inherit name="editor_room" />
      <usedefaultprefix />
      <descriptions type="stringdictionary">
        <item>
          <key>darknorth</key>
          <value>You cannot see anything. You feel as if you have faded into the darkness. You can feel a bookshelf to the south of you.</value>
        </item>
        <item>
          <key>darkeast</key>
          <value>You cannot see anything. You feel as if you have faded into the darkness.</value>
        </item>
        <item>
          <key>darksouth</key>
          <value>You cannot see anything. You feel as if you have faded into the darkness. You can feel a bookshelf in front of you.</value>
        </item>
        <item>
          <key>darkwest</key>
          <value>You cannot see anything. You feel as if you have faded into the darkness.</value>
        </item>
        <item>
          <key>dimnorth</key>
          <value>There is an angry shadowy creature standing over you, a step forwards. He is snarling at your lantern, and is raising his fist. </value>
        </item>
        <item>
          <key>dimeast</key>
          <value>There is a bookshelf to the south of you. There is an angry shadowy creature standing over you, a step north. He is snarling at your lantern, and is raising his fist. </value>
        </item>
        <item>
          <key>dimsouth</key>
          <value>There is a bookshelf in front of you. You are in a small room. You hear angry snarling from behind you, and hot breath cascading over your neck.</value>
        </item>
        <item>
          <key>dimwest</key>
          <value>There is a bookshelf to the south of you. There is an angry shadowy creature standing over you, a step north. He is snarling at your lantern, and is raising his fist. </value>
        </item>
        <item>
          <key>brightnorth</key>
          <value>There is an angry shadowy creature standing over you, a step forwards. He is snarling at your lantern, and is raising his fist. </value>
        </item>
        <item>
          <key>brighteast</key>
          <value>There is a bookshelf to the south of you. There is an angry shadowy creature standing over you, a step north. He is snarling at your lantern, and is raising his fist. </value>
        </item>
        <item>
          <key>brightsouth</key>
          <value>There is a bookshelf in front of you. You are in a small room. You hear angry snarling from behind you, and hot breath cascading over your neck.</value>
        </item>
        <item>
          <key>brightwest</key>
          <value>There is a bookshelf to the south of you. There is an angry shadowy creature standing over you, a step north. He is snarling at your lantern, and is raising his fist. </value>
        </item>
      </descriptions>
      <description type="script">
        PrintRoomDesc (False)
      </description>
      <exit name="West178" alias="west" to="defaultroom">
        <inherit name="westdirection" />
        <runscript />
        <visible />
        <script type="script">
          MoveAndFace (library49, 3)
        </script>
      </exit>
      <exit name="East179" alias="east" to="defaultroom">
        <inherit name="eastdirection" />
        <runscript />
        <script type="script">
          MoveAndFace (library65, 1)
        </script>
      </exit>
    </object>
    <object name="library58">
      <inherit name="editor_room" />
      <usedefaultprefix />
      <descriptions type="stringdictionary">
        <item>
          <key>darknorth</key>
          <value>TODO: implement this description</value>
        </item>
        <item>
          <key>darkeast</key>
          <value>TODO: implement this description</value>
        </item>
        <item>
          <key>darksouth</key>
          <value>TODO: implement this description</value>
        </item>
        <item>
          <key>darkwest</key>
          <value>TODO: implement this description</value>
        </item>
        <item>
          <key>dimnorth</key>
          <value>TODO: implement this description</value>
        </item>
        <item>
          <key>dimeast</key>
          <value>TODO: implement this description</value>
        </item>
        <item>
          <key>dimsouth</key>
          <value>TODO: implement this description</value>
        </item>
        <item>
          <key>dimwest</key>
          <value>TODO: implement this description</value>
        </item>
        <item>
          <key>brightnorth</key>
          <value>TODO: implement this description</value>
        </item>
        <item>
          <key>brighteast</key>
          <value>TODO: implement this description</value>
        </item>
        <item>
          <key>brightsouth</key>
          <value>TODO: implement this description</value>
        </item>
        <item>
          <key>brightwest</key>
          <value>TODO: implement this description</value>
        </item>
      </descriptions>
      <description type="script">
        msg ("The tall creature looks at you, and snarls. He is towering over you, and you can feel his breath on your face. He brings his face as close to yours as possible, and roars louder than you have ever heard before. You are disoriented, and deaf. You can feel warm blood run down the sides of your face from your ears. You start getting dizzy, but before you can faint the creature raises a fist and...")
        Die
      </description>
      <exit name="West179" alias="west" to="defaultroom">
        <inherit name="westdirection" />
        <runscript />
        <visible />
        <script type="script">
          MoveAndFace (library51, 3)
        </script>
      </exit>
      <exit name="East180" alias="east" to="defaultroom">
        <inherit name="eastdirection" />
        <runscript />
        <script type="script">
          MoveAndFace (library67, 1)
        </script>
      </exit>
      <exit name="North192" alias="north" to="defaultroom">
        <inherit name="northdirection" />
        <runscript />
        <script type="script">
          MoveAndFace (library59, 0)
        </script>
      </exit>
    </object>
    <object name="library59">
      <inherit name="editor_room" />
      <usedefaultprefix />
      <descriptions type="stringdictionary">
        <item>
          <key>darknorth</key>
          <value>You cannot see anything. You feel as if you have faded into the darkness. You can feel a bookshelf in front of you.</value>
        </item>
        <item>
          <key>darkeast</key>
          <value>You cannot see anything. You feel as if you have faded into the darkness.</value>
        </item>
        <item>
          <key>darksouth</key>
          <value>You cannot see anything. You feel as if you have faded into the darkness.</value>
        </item>
        <item>
          <key>darkwest</key>
          <value>You cannot see anything. You feel as if you have faded into the darkness.</value>
        </item>
        <item>
          <key>dimnorth</key>
          <value>There is a bookshelf in front of you. You are in a small room. You can hear noises from the creature in the middle of the room, he is snarling.</value>
        </item>
        <item>
          <key>dimeast</key>
          <value>There is a bookshelf to the north of you. There is a shadowy creature to the south of you, he is growling and seems to be looking for the source of the light.</value>
        </item>
        <item>
          <key>dimsouth</key>
          <value>You are in a small room, a few steps ahead there is a tall, bpath shadowy creature. He is angrily looking around, trying to find the source of the light.</value>
        </item>
        <item>
          <key>dimwest</key>
          <value>There is a bookshelf to the north of you. To the south stands a tall, bpath shadowy creature. He is angrily looking around, trying to find the source of the light.</value>
        </item>
        <item>
          <key>brightnorth</key>
          <value>There is a bookshelf to the south of you. There is an angry shadowy creature standing over you, a step north. He is snarling at your lantern, and is raising his fist. </value>
        </item>
        <item>
          <key>brighteast</key>
          <value>There is a bookshelf to the north of you. There is a shadowy creature to the south of you, he is growling and seems to be looking for the source of the light. </value>
        </item>
        <item>
          <key>brightsouth</key>
          <value>You are in a small room, a few steps ahead there is a tall, bpath shadowy creature. He is angrily looking around, trying to find the source of the light.</value>
        </item>
        <item>
          <key>brightwest</key>
          <value>There is a bookshelf to the north of you. To the south stands a tall, bpath shadowy creature. He is angrily looking around, trying to find the source of the light.</value>
        </item>
      </descriptions>
      <description type="script">
        PrintRoomDesc (False)
      </description>
      <exit name="West180" alias="west" to="defaultroom">
        <inherit name="westdirection" />
        <runscript />
        <visible />
        <script type="script">
          MoveAndFace (library52, 3)
        </script>
      </exit>
      <exit name="South194" alias="south" to="defaultroom">
        <inherit name="southdirection" />
        <runscript />
        <script type="script">
          MoveAndFace (library58, 2)
        </script>
      </exit>
      <exit name="East181" alias="east" to="defaultroom">
        <inherit name="eastdirection" />
        <runscript />
        <script type="script">
          MoveAndFace (library68, 1)
        </script>
      </exit>
    </object>
    <object name="library60">
      <inherit name="editor_room" />
      <usedefaultprefix />
      <descriptions type="stringdictionary">
        <item>
          <key>darknorth</key>
          <value>You cannot see anything. You feel as if you have faded into the darkness. You can feel a bookshelf in front of you.</value>
        </item>
        <item>
          <key>darkeast</key>
          <value>You cannot see anything. You feel as if you have faded into the darkness.</value>
        </item>
        <item>
          <key>darksouth</key>
          <value>You cannot see anything. You feel as if you have faded into the darkness. You can feel a bookshelf in front of you.</value>
        </item>
        <item>
          <key>darkwest</key>
          <value>You cannot see anything. You feel as if you have faded into the darkness.</value>
        </item>
        <item>
          <key>dimnorth</key>
          <value>There is a bookshelf in front of you. There is a bright yellow book laying open on the shelf. The book seems to be discussing necromancy, and eternal life.</value>
        </item>
        <item>
          <key>dimeast</key>
          <value>There is a bookshelf to the south, and the north of you. The bookshelf to the north has a bright yellow book laying open on it. The books seems to be about necromancy, and eternal life.</value>
        </item>
        <item>
          <key>dimsouth</key>
          <value>There is a bookshelf in front of you.</value>
        </item>
        <item>
          <key>dimwest</key>
          <value>There is a bookshelf to the south, and to the north of you. There is a bright yellow book laying open upon the shelf. It seems to be discussing necromancy, and eternal life.</value>
        </item>
        <item>
          <key>brightnorth</key>
          <value>The bright light hurts your eyes. There is a bookshelf in front of you. There is a bookshelf in front of you. There is a bright yellow book laying open on the shelf. The book seems to be discussing necromancy, and eternal life.</value>
        </item>
        <item>
          <key>brighteast</key>
          <value>The bright light hurts your eyes. There is a bookshelf to the south, and the north of you. The bookshelf to the north has a bright yellow book laying open on it. The books seems to be about necromancy, and eternal life.</value>
        </item>
        <item>
          <key>brightsouth</key>
          <value>The bright light hurts your eyes. There is a bookshelf in front of you.</value>
        </item>
        <item>
          <key>brightwest</key>
          <value>The bright light hurts your eyes. There is a bookshelf to the south, and to the north of you. There is a bright yellow book laying open upon the shelf. It seems to be discussing necromancy, and eternal life.</value>
        </item>
      </descriptions>
      <description type="script">
        PrintRoomDesc (False)
      </description>
      <exit name="West181" alias="west" to="defaultroom">
        <inherit name="westdirection" />
        <runscript />
        <visible />
        <script type="script">
          MoveAndFace (library54, 3)
        </script>
      </exit>
      <exit name="East182" alias="east" to="defaultroom">
        <inherit name="eastdirection" />
        <runscript />
        <script type="script">
          MoveAndFace (library69, 1)
        </script>
      </exit>
    </object>
    <object name="library62">
      <inherit name="editor_room" />
      <usedefaultprefix />
      <descriptions type="stringdictionary">
        <item>
          <key>darknorth</key>
          <value>You cannot see anything. You feel as if you have faded into the darkness. </value>
        </item>
        <item>
          <key>darkeast</key>
          <value>You cannot see anything. You feel as if you have faded into the darkness. You can feel a bookshelf in front of you.</value>
        </item>
        <item>
          <key>darksouth</key>
          <value>You cannot see anything. You feel as if you have faded into the darkness. You can feel a small table in front of you.</value>
        </item>
        <item>
          <key>darkwest</key>
          <value>You cannot see anything. You feel as if you have faded into the darkness. You can feel a bookshelf in front of you.</value>
        </item>
        <item>
          <key>dimnorth</key>
          <value>There is a bookshelf to the east, and west of you. </value>
        </item>
        <item>
          <key>dimeast</key>
          <value>There is a bookshelf in front of you. There is a small table to the south of you.</value>
        </item>
        <item>
          <key>dimsouth</key>
          <value>There is a small table in front of you. There is a bookshelf to the east, and the west of you.</value>
        </item>
        <item>
          <key>dimwest</key>
          <value>There is a bookshelf in front of you. There is a small table to the south of you.</value>
        </item>
        <item>
          <key>brightnorth</key>
          <value>There is a bookshelf to the east, and west of you. The path continues forwards.</value>
        </item>
        <item>
          <key>brighteast</key>
          <value>There is a bookshelf in front of you. There is a small table to the south of you.</value>
        </item>
        <item>
          <key>brightsouth</key>
          <value>There is a small table in front of you. There is a bookshelf to the east, and the west of you.</value>
        </item>
        <item>
          <key>brightwest</key>
          <value>There is a bookshelf in front of you. There is a small table to the south of you.</value>
        </item>
      </descriptions>
      <description type="script"><![CDATA[
        PrintRoomDesc (False)
        if (not oil9.parent = null and lantern.light_level > 0) {
          if (player.facing_num = 2) {
            msg ("There is a cask of oil sitting on the table in front of you.")
          }
          else if (player.facing_num <> 0) {
            msg ("There is a cask of oil sitting on the table to the south.")
          }
        }
      ]]></description>
      <exit name="North196" alias="north" to="defaultroom">
        <inherit name="northdirection" />
        <runscript />
        <script type="script">
          MoveAndFace (library63, 0)
        </script>
      </exit>
      <object name="oil9">
        <inherit name="editor_object" />
        <alt type="stringlist">
          <value>cask</value>
        </alt>
        <alias>oil</alias>
        <scenery />
        <feature_usegive />
        <take type="script">
          GetOil (oil9)
        </take>
        <use type="script">
          GetOil (oil9)
        </use>
      </object>
    </object>
    <object name="library63">
      <inherit name="editor_room" />
      <usedefaultprefix />
      <descriptions type="stringdictionary">
        <item>
          <key>darknorth</key>
          <value>You cannot see anything. You feel as if you have faded into the darkness. You can feel a bookshelf in front of you.</value>
        </item>
        <item>
          <key>darkeast</key>
          <value>You cannot see anything. You feel as if you have faded into the darkness. You can feel a bookshelf in front of you.</value>
        </item>
        <item>
          <key>darksouth</key>
          <value>You cannot see anything. You feel as if you have faded into the darkness.</value>
        </item>
        <item>
          <key>darkwest</key>
          <value>You cannot see anything. You feel as if you have faded into the darkness.</value>
        </item>
        <item>
          <key>dimnorth</key>
          <value>There is a bookshelf in front of you, and to the east of you.</value>
        </item>
        <item>
          <key>dimeast</key>
          <value>There is a bookshelf in front of you, and to the north of you.</value>
        </item>
        <item>
          <key>dimsouth</key>
          <value>There is a bookshelf to the east of you.</value>
        </item>
        <item>
          <key>dimwest</key>
          <value>There is a bookshelf to the north of you.</value>
        </item>
        <item>
          <key>brightnorth</key>
          <value>There is a bookshelf in front of you, and to the east of you. The path continues to the west.</value>
        </item>
        <item>
          <key>brighteast</key>
          <value>There is a bookshelf in front of you, and to the north of you. The path continues to the west.</value>
        </item>
        <item>
          <key>brightsouth</key>
          <value>There is a bookshelf to the east of you. The path continues to the south, and the west of you.</value>
        </item>
        <item>
          <key>brightwest</key>
          <value>There is a bookshelf to the north of you. The path continues forwards.</value>
        </item>
      </descriptions>
      <description type="script">
        PrintRoomDesc (False)
      </description>
      <exit name="West184" alias="west" to="defaultroom">
        <inherit name="westdirection" />
        <runscript />
        <visible />
        <script type="script">
          MoveAndFace (library55, 3)
        </script>
      </exit>
      <exit name="South198" alias="south" to="defaultroom">
        <inherit name="southdirection" />
        <runscript />
        <script type="script">
          MoveAndFace (library62, 2)
        </script>
      </exit>
    </object>
    <object name="library64">
      <inherit name="editor_room" />
      <usedefaultprefix />
      <descriptions type="stringdictionary">
        <item>
          <key>darknorth</key>
          <value>You cannot see anything. You feel as if you have faded into the darkness. You can feel a bookshelf in front of you.</value>
        </item>
        <item>
          <key>darkeast</key>
          <value>You cannot see anything. You feel as if you have faded into the darkness.</value>
        </item>
        <item>
          <key>darksouth</key>
          <value>You cannot see anything. You feel as if you have faded into the darkness. You can feel a bookshelf in front of you.</value>
        </item>
        <item>
          <key>darkwest</key>
          <value>You cannot see anything. You feel as if you have faded into the darkness.</value>
        </item>
        <item>
          <key>dimnorth</key>
          <value>There is a bookshelf in front of you. </value>
        </item>
        <item>
          <key>dimeast</key>
          <value>There is a bookshelf to the south, and the north of you.</value>
        </item>
        <item>
          <key>dimsouth</key>
          <value>There is a bookshelf in front of you. </value>
        </item>
        <item>
          <key>dimwest</key>
          <value>There is a bookshelf to the south, and the north of you.</value>
        </item>
        <item>
          <key>brightnorth</key>
          <value>There is a bookshelf in front of you. The path continues to the west, and east of you.</value>
        </item>
        <item>
          <key>brighteast</key>
          <value>There is a bookshelf to the south, and the north of you. The path continues forwards.</value>
        </item>
        <item>
          <key>brightsouth</key>
          <value>There is a bookshelf in front of you. The path continues to the west, and east of you.</value>
        </item>
        <item>
          <key>brightwest</key>
          <value>There is a bookshelf to the south, and the north of you. The path continues forwards.</value>
        </item>
      </descriptions>
      <description type="script">
        PrintRoomDesc (False)
      </description>
      <exit name="West185" alias="west" to="defaultroom">
        <inherit name="westdirection" />
        <runscript />
        <visible />
        <script type="script">
          MoveAndFace (library56, 3)
        </script>
      </exit>
      <exit name="East186" alias="east" to="defaultroom">
        <inherit name="eastdirection" />
        <runscript />
        <script type="script">
          MoveAndFace (library70, 1)
        </script>
      </exit>
    </object>
    <object name="library65">
      <inherit name="editor_room" />
      <usedefaultprefix />
      <descriptions type="stringdictionary">
        <item>
          <key>darknorth</key>
          <value>You cannot see anything. You feel as if you have faded into the darkness. You can feel a bookshelf to the east of you.</value>
        </item>
        <item>
          <key>darkeast</key>
          <value>You cannot see anything. You feel as if you have faded into the darkness. You can feel a bookshelf in front of you.</value>
        </item>
        <item>
          <key>darksouth</key>
          <value>You cannot see anything. You feel as if you have faded into the darkness. You can feel a bookshelf in front of you.</value>
        </item>
        <item>
          <key>darkwest</key>
          <value>You cannot see anything. You feel as if you have faded into the darkness.</value>
        </item>
        <item>
          <key>dimnorth</key>
          <value>There is a bookshelf to the east of you. Northwest of you stands a shadowy humanoid creature, that is snarling and is in search of the source of the light.</value>
        </item>
        <item>
          <key>dimeast</key>
          <value>There is a bookshelf in front of you, and to the south. You are in a small room. You can hear growling coming from behind you.</value>
        </item>
        <item>
          <key>dimsouth</key>
          <value>There is a bookshelf in front of you, and to the east of you. You can hear snarling from behind you.</value>
        </item>
        <item>
          <key>dimwest</key>
          <value>There is a bookshelf to the south of you. There is a shadowy creature standing tall to the northwest of you. He is glaring at your lantern, and growling.</value>
        </item>
        <item>
          <key>brightnorth</key>
          <value>There is a bookshelf to the east of you. Northwest of you stands a shadowy humanoid creature, that is snarling and is in search of the source of the light.</value>
        </item>
        <item>
          <key>brighteast</key>
          <value>There is a bookshelf in front of you, and to the south of you. You are in a small room. You can hear growling coming from behind you.</value>
        </item>
        <item>
          <key>brightsouth</key>
          <value>There is a bookshelf in front of you, and to the east of you. You can hear snarling from behind you.</value>
        </item>
        <item>
          <key>brightwest</key>
          <value>There is a bookshelf to the south of you. There is a shadowy creature standing tall to the northwest of you. He is glaring at your lantern, and growling.</value>
        </item>
      </descriptions>
      <description type="script">
        PrintRoomDesc (False)
      </description>
      <exit name="West186" alias="west" to="defaultroom">
        <inherit name="westdirection" />
        <runscript />
        <visible />
        <script type="script">
          MoveAndFace (library57, 3)
        </script>
      </exit>
      <exit name="North199" alias="north" to="defaultroom">
        <inherit name="northdirection" />
        <runscript />
        <script type="script">
          MoveAndFace (library66, 0)
        </script>
      </exit>
    </object>
    <object name="library66">
      <inherit name="editor_room" />
      <usedefaultprefix />
      <descriptions type="stringdictionary">
        <item>
          <key>darknorth</key>
          <value>You cannot see anything. You feel as if you have faded into the darkness. You can feel a bookshelf the east of you.</value>
        </item>
        <item>
          <key>darkeast</key>
          <value>You cannot see anything. You feel as if you have faded into the darkness. You can feel a bookshelf in front of you.</value>
        </item>
        <item>
          <key>darksouth</key>
          <value>You cannot see anything. You feel as if you have faded into the darkness.</value>
        </item>
        <item>
          <key>darkwest</key>
          <value>You cannot see anything. You feel as if you have faded into the darkness.</value>
        </item>
        <item>
          <key>dimnorth</key>
          <value>There is a bookshelf to the east of you. There is a tall, and bpath shadowy creature to the west of you. He is towering over you, and glaring with hollow eyes at the lantern. He is snarling, and raising his fist to strike.</value>
        </item>
        <item>
          <key>dimeast</key>
          <value>There is a bookshelf in front of you. You are in a small room, and can hear growling and snarling coming from behind you. You can feel hot breath cascading down the back of your neck.</value>
        </item>
        <item>
          <key>dimsouth</key>
          <value>There is a bookshelf to the east of you. Directly to the west of you stands a tall shadowy creature. He is towering over you, growling at the lantern.</value>
        </item>
        <item>
          <key>dimwest</key>
          <value>You are in a small room. The shadowy creature is right in front of you. He is towering over you, growling, and raising his fists to strike at you.</value>
        </item>
        <item>
          <key>brightnorth</key>
          <value>There is a bookshelf to the east of you. There is a tall, and bpath shadowy creature to the west of you. He is towering over you, and glaring with hollow eyes at the lantern. He is snarling, and raising his fist to strike.</value>
        </item>
        <item>
          <key>brighteast</key>
          <value>There is a bookshelf in front of you. You are in a small room, and can hear growling and snarling coming from behind you. You can feel hot breath cascading down the back of your neck. </value>
        </item>
        <item>
          <key>brightsouth</key>
          <value>There is a bookshelf to the east of you. Directly to the west of you stands a tall shadowy creature. He is towering over you, growling at the lantern.</value>
        </item>
        <item>
          <key>brightwest</key>
          <value>You are in a small room. The shadowy creature is right in front of you. He is towering over you, growling, and raising his fists to strike at you.</value>
        </item>
      </descriptions>
      <description type="script">
        PrintRoomDesc (False)
      </description>
      <exit name="South201" alias="south" to="defaultroom">
        <inherit name="southdirection" />
        <runscript />
        <script type="script">
          MoveAndFace (library65, 2)
        </script>
      </exit>
      <exit name="North200" alias="north" to="defaultroom">
        <inherit name="northdirection" />
        <runscript />
        <script type="script">
          MoveAndFace (library67, 0)
        </script>
      </exit>
    </object>
    <object name="library67">
      <inherit name="editor_room" />
      <usedefaultprefix />
      <descriptions type="stringdictionary">
        <item>
          <key>darknorth</key>
          <value>You cannot see anything. You feel as if you have faded into the darkness. </value>
        </item>
        <item>
          <key>darkeast</key>
          <value>You cannot see anything. You feel as if you have faded into the darkness. You can feel a space between the bookshelves in front of you that you could exit the room from.</value>
        </item>
        <item>
          <key>darksouth</key>
          <value>You cannot see anything. You feel as if you have faded into the darkness.</value>
        </item>
        <item>
          <key>darkwest</key>
          <value>You cannot see anything. You feel as if you have faded into the darkness.</value>
        </item>
        <item>
          <key>dimnorth</key>
          <value>You are in a small room, there is an exit to the room to the east of you in between some bookshelves. You can hear growling and snarling coming from close behind you. </value>
        </item>
        <item>
          <key>dimeast</key>
          <value>You are in a small room, a step forwards you can go between two bookshelves and exit the room. There is growling and snarling coming from behind you.</value>
        </item>
        <item>
          <key>dimsouth</key>
          <value>There is an exit to the small room to the east of you. There is a tall shadowy humanoid creature to the south west of you. He is snarling, and glaring right at your lantern. </value>
        </item>
        <item>
          <key>dimwest</key>
          <value>You are in a small room. There is a tall shadowy humanoid creature to the southwest of you. He is growling angrily, and seems like he might strike.</value>
        </item>
        <item>
          <key>brightnorth</key>
          <value>You are in a small room, there is an exit to the room to the east of you in between some bookshelves. You can hear growling and snarling coming from close behind you. </value>
        </item>
        <item>
          <key>brighteast</key>
          <value>You are in a small room, a step forwards you can go between two bookshelves and exit the room. There is growling and snarling coming from behind you.</value>
        </item>
        <item>
          <key>brightsouth</key>
          <value>There is an exit to the small room to the east of you. There is a tall shadowy humanoid creature to the south west of you. He is snarling, and glaring right at your lantern. </value>
        </item>
        <item>
          <key>brightwest</key>
          <value>You are in a small room. There is a tall shadowy humanoid creature to the southwest of you. He is growling angrily, and seems like he might strike.</value>
        </item>
      </descriptions>
      <description type="script">
        PrintRoomDesc (False)
      </description>
      <exit name="West188" alias="west" to="defaultroom">
        <inherit name="westdirection" />
        <runscript />
        <visible />
        <script type="script">
          MoveAndFace (library58, 3)
        </script>
      </exit>
      <exit name="South202" alias="south" to="defaultroom">
        <inherit name="southdirection" />
        <runscript />
        <script type="script">
          MoveAndFace (library66, 2)
        </script>
      </exit>
      <exit name="East189" alias="east" to="defaultroom">
        <inherit name="eastdirection" />
        <runscript />
        <script type="script">
          MoveAndFace (library72, 1)
        </script>
      </exit>
      <exit name="North201" alias="north" to="defaultroom">
        <inherit name="northdirection" />
        <runscript />
        <script type="script">
          MoveAndFace (library68, 0)
        </script>
      </exit>
    </object>
    <object name="library68">
      <inherit name="editor_room" />
      <usedefaultprefix />
      <descriptions type="stringdictionary">
        <item>
          <key>darknorth</key>
          <value>You cannot see anything. You feel as if you have faded into the darkness. You can feel a bookshelf in front of you.</value>
        </item>
        <item>
          <key>darkeast</key>
          <value>You cannot see anything. You feel as if you have faded into the darkness. You can feel a bookshelf in front of you.</value>
        </item>
        <item>
          <key>darksouth</key>
          <value>You cannot see anything. You feel as if you have faded into the darkness. You can feel a bookshelf to the east of you.</value>
        </item>
        <item>
          <key>darkwest</key>
          <value>You cannot see anything. You feel as if you have faded into the darkness. You can feel a bookshelf to the north.</value>
        </item>
        <item>
          <key>dimnorth</key>
          <value>There is a bookshelf in front of you, and to the east of you. You are in a small room, you can hear snarling and growling coming from behind you.</value>
        </item>
        <item>
          <key>dimeast</key>
          <value>There is a bookshelf in front of you, and to the north of you. There is a shadowy creature to the southwest of you. He is snarling and searching for the source of the light. </value>
        </item>
        <item>
          <key>dimsouth</key>
          <value>There is a bookshelf to the east of you, you are in a small room. There is a shadowy creature in the middle of the room, he is growling and searching for the source of the light.</value>
        </item>
        <item>
          <key>dimwest</key>
          <value>There is a bookshelf to the north of you. There is a shadowy creature in the middle of the room, he is snarling, and growling while searching for the source of the light.</value>
        </item>
        <item>
          <key>brightnorth</key>
          <value>There is a bookshelf in front of you, and to the east of you. You are in a small room, you can hear snarling and growling coming from behind you.</value>
        </item>
        <item>
          <key>brighteast</key>
          <value>There is a bookshelf in front of you, and to the north of you. There is a shadowy creature to the southwest of you. He is snarling and searching for the source of the light.</value>
        </item>
        <item>
          <key>brightsouth</key>
          <value>There is a bookshelf to the east of you, you are in a small room. There is a shadowy creature in the middle of the room, he is growling and searching for the source of the light.</value>
        </item>
        <item>
          <key>brightwest</key>
          <value>There is a bookshelf to the north of you. There is a shadowy creature in the middle of the room, he is snarling, and growling while searching for the source of the light.</value>
        </item>
      </descriptions>
      <description type="script">
        PrintRoomDesc (False)
      </description>
      <exit name="West189" alias="west" to="defaultroom">
        <inherit name="westdirection" />
        <runscript />
        <visible />
        <script type="script">
          MoveAndFace (library59, 3)
        </script>
      </exit>
      <exit name="South203" alias="south" to="defaultroom">
        <inherit name="southdirection" />
        <runscript />
        <script type="script">
          MoveAndFace (library67, 2)
        </script>
      </exit>
    </object>
    <object name="library69">
      <inherit name="editor_room" />
      <usedefaultprefix />
      <descriptions type="stringdictionary">
        <item>
          <key>darknorth</key>
          <value>You cannot see anything. You feel as if you have faded into the darkness. You can feel a bookshelf in front of you.</value>
        </item>
        <item>
          <key>darkeast</key>
          <value>You cannot see anything. You feel as if you have faded into the darkness. You can feel bookshelves to the south, and north of you.</value>
        </item>
        <item>
          <key>darksouth</key>
          <value>You cannot see anything. You feel as if you have faded into the darkness. You can feel a bookshelf in front of you.</value>
        </item>
        <item>
          <key>darkwest</key>
          <value>You cannot see anything. You feel as if you have faded into the darkness. You can feel bookshelves to the north, and south of you.</value>
        </item>
        <item>
          <key>dimnorth</key>
          <value>There is a bookshelf in front of you. </value>
        </item>
        <item>
          <key>dimeast</key>
          <value>There is a bookshelf to the north, and the south of you.</value>
        </item>
        <item>
          <key>dimsouth</key>
          <value>There is a bookshelf in front of you. </value>
        </item>
        <item>
          <key>dimwest</key>
          <value>There is a bookshelf to the north, and the south of you. </value>
        </item>
        <item>
          <key>brightnorth</key>
          <value>The bright light hurts your eyes. There is a bookshelf in front of you.</value>
        </item>
        <item>
          <key>brighteast</key>
          <value>The bright light hurts your eyes. There is a bookshelf to the north, and the south of you.</value>
        </item>
        <item>
          <key>brightsouth</key>
          <value>The bright light hurts your eyes. There is a bookshelf in front of you.</value>
        </item>
        <item>
          <key>brightwest</key>
          <value>The bright light hurts your eyes. There is a bookshelf to the north, and the south of you.</value>
        </item>
      </descriptions>
      <description type="script">
        PrintRoomDesc (False)
      </description>
      <exit name="West190" alias="west" to="defaultroom">
        <inherit name="westdirection" />
        <runscript />
        <visible />
        <script type="script">
          MoveAndFace (library60, 3)
        </script>
      </exit>
      <exit name="East191" alias="east" to="defaultroom">
        <inherit name="eastdirection" />
        <runscript />
        <script type="script">
          MoveAndFace (library73, 1)
        </script>
      </exit>
    </object>
    <object name="library70">
      <inherit name="editor_room" />
      <usedefaultprefix />
      <descriptions type="stringdictionary">
        <item>
          <key>darknorth</key>
          <value>You cannot see anything. You feel as if you have faded into the darkness. </value>
        </item>
        <item>
          <key>darkeast</key>
          <value>You cannot see anything. You feel as if you have faded into the darkness.</value>
        </item>
        <item>
          <key>darksouth</key>
          <value>You cannot see anything. You feel as if you have faded into the darkness. You can feel a bookshelf in front of you.</value>
        </item>
        <item>
          <key>darkwest</key>
          <value>You cannot see anything. You feel as if you have faded into the darkness.</value>
        </item>
        <item>
          <key>dimnorth</key>
          <value>The bookshelf a step forwards looks odd in comparison with the others you have seen so far. The path continues forwards, to the west, and to the east of you.</value>
        </item>
        <item>
          <key>dimeast</key>
          <value>There is a bookshelf to the south of you. </value>
        </item>
        <item>
          <key>dimsouth</key>
          <value>There is a bookshelf in front of you.</value>
        </item>
        <item>
          <key>dimwest</key>
          <value>There is a bookshelf to the south of you.</value>
        </item>
        <item>
          <key>brightnorth</key>
          <value>The bookshelf a step forwards looks odd in comparison with the others you have seen so far. The path continues forwards, to the west, and to the east of you.</value>
        </item>
        <item>
          <key>brighteast</key>
          <value>There is a bookshelf to the south of you. The path continues forwards.</value>
        </item>
        <item>
          <key>brightsouth</key>
          <value>There is a bookshelf in front of you. The path continues to the east, and west of you.</value>
        </item>
        <item>
          <key>brightwest</key>
          <value>There is a bookshelf to the south of you. The path continues forwards.</value>
        </item>
      </descriptions>
      <description type="script"><![CDATA[
        if (player.facing_num = 0 and library71.collapsed and lantern.light_level > 0) {
          msg ("The bookshelf a step forwards has collapsed and is blocking you from moving forward. The path continues to the west, and to the east of you.")
        }
        else {
          PrintRoomDesc (False)
        }
      ]]></description>
      <exit name="West191" alias="west" to="defaultroom">
        <inherit name="westdirection" />
        <runscript />
        <visible />
        <script type="script">
          MoveAndFace (library64, 3)
        </script>
      </exit>
      <exit name="East192" alias="east" to="defaultroom">
        <inherit name="eastdirection" />
        <runscript />
        <script type="script">
          MoveAndFace (library74, 1)
        </script>
      </exit>
      <exit name="North204" alias="north" to="defaultroom">
        <inherit name="northdirection" />
        <runscript />
        <script type="script">
          msg ("You accidentally stumble into the bookshelf. The wood on the shelf is rotting away, causing it to collapse from the added weight, and falls on top of you. The lantern is knocked out of your hands, and rolls away leaking oil out onto the floor. You think you hear something running towards you, and hold your breath. The silence rings in your ears, and you realize you dont hear anything anymore. It must have been your imagination. You pull yourself out of the rubble, stand up, walk over to your lantern and pick it up.")
          JumpScare
          lantern.fuel_level = lantern.fuel_level / 2
          North204.visible = false
          West196.visible = false
          library74.collapsed = true
        </script>
      </exit>
    </object>
    <object name="library71">
      <inherit name="editor_room" />
      <usedefaultprefix />
      <descriptions type="stringdictionary">
        <item>
          <key>darknorth</key>
          <value>TODO: implement this description</value>
        </item>
        <item>
          <key>darkeast</key>
          <value>TODO: implement this description</value>
        </item>
        <item>
          <key>darksouth</key>
          <value>TODO: implement this description</value>
        </item>
        <item>
          <key>darkwest</key>
          <value>TODO: implement this description</value>
        </item>
        <item>
          <key>dimnorth</key>
          <value>TODO: implement this description</value>
        </item>
        <item>
          <key>dimeast</key>
          <value>TODO: implement this description</value>
        </item>
        <item>
          <key>dimsouth</key>
          <value>TODO: implement this description</value>
        </item>
        <item>
          <key>dimwest</key>
          <value>TODO: implement this description</value>
        </item>
        <item>
          <key>brightnorth</key>
          <value>TODO: implement this description</value>
        </item>
        <item>
          <key>brighteast</key>
          <value>TODO: implement this description</value>
        </item>
        <item>
          <key>brightsouth</key>
          <value>TODO: implement this description</value>
        </item>
        <item>
          <key>brightwest</key>
          <value>TODO: implement this description</value>
        </item>
      </descriptions>
      <collapsed type="boolean">false</collapsed>
      <description type="script">
        PrintRoomDesc (False)
      </description>
      <exit name="South206" alias="south" to="defaultroom">
        <inherit name="southdirection" />
        <runscript />
        <script type="script">
          MoveAndFace (library70, 2)
        </script>
      </exit>
      <exit name="East193" alias="east" to="defaultroom">
        <inherit name="eastdirection" />
        <runscript />
        <script type="script">
          MoveAndFace (library75, 1)
        </script>
      </exit>
    </object>
    <object name="library72">
      <inherit name="editor_room" />
      <usedefaultprefix />
      <descriptions type="stringdictionary">
        <item>
          <key>darknorth</key>
          <value>You cannot see anything. You feel as if you have faded into the darkness. You can feel a bookshelf in front of you.</value>
        </item>
        <item>
          <key>darkeast</key>
          <value>You cannot see anything. You feel as if you have faded into the darkness.</value>
        </item>
        <item>
          <key>darksouth</key>
          <value>You cannot see anything. You feel as if you have faded into the darkness. You can feel a bookshelf in front of you.</value>
        </item>
        <item>
          <key>darkwest</key>
          <value>You cannot see anything. You feel as if you have faded into the darkness.</value>
        </item>
        <item>
          <key>dimnorth</key>
          <value>There is a bookshelf in front of you. To the west of you is a small room.</value>
        </item>
        <item>
          <key>dimeast</key>
          <value>There is a bookshelf to the south, and north of you.</value>
        </item>
        <item>
          <key>dimsouth</key>
          <value>There is a bookshelf in front of you. To the west of you is a small room.</value>
        </item>
        <item>
          <key>dimwest</key>
          <value>There is a bookshelf to the north, and the south of you. A step forwards is a small room.</value>
        </item>
        <item>
          <key>brightnorth</key>
          <value>There is a bookshelf in front of you. To the west of you is a small room.</value>
        </item>
        <item>
          <key>brighteast</key>
          <value>There is a bookshelf to the south, and north of you. The path continues forwards.</value>
        </item>
        <item>
          <key>brightsouth</key>
          <value>There is a bookshelf in front of you. To the west of you is a small room.</value>
        </item>
        <item>
          <key>brightwest</key>
          <value>There is a bookshelf to the north, and the south of you. A step forwards is a small room. </value>
        </item>
      </descriptions>
      <description type="script">
        PrintRoomDesc (False)
      </description>
      <exit name="West193" alias="west" to="defaultroom">
        <inherit name="westdirection" />
        <runscript />
        <visible />
        <script type="script">
          MoveAndFace (library67, 3)
        </script>
      </exit>
      <exit name="East194" alias="east" to="defaultroom">
        <inherit name="eastdirection" />
        <runscript />
        <script type="script">
          MoveAndFace (library79, 1)
        </script>
      </exit>
    </object>
    <object name="library73">
      <inherit name="editor_room" />
      <usedefaultprefix />
      <descriptions type="stringdictionary">
        <item>
          <key>darknorth</key>
          <value>You cannot see anything. You feel as if you have faded into the darkness. You can feel a bookshelf in front of you.</value>
        </item>
        <item>
          <key>darkeast</key>
          <value>You cannot see anything. You feel as if you have faded into the darkness.</value>
        </item>
        <item>
          <key>darksouth</key>
          <value>You cannot see anything. You feel as if you have faded into the darkness. You can feel a bookshelf in front of you.</value>
        </item>
        <item>
          <key>darkwest</key>
          <value>You cannot see anything. You feel as if you have faded into the darkness.</value>
        </item>
        <item>
          <key>dimnorth</key>
          <value>There is a bookshelf in front of you.</value>
        </item>
        <item>
          <key>dimeast</key>
          <value>There is a bookshelf to the south, and to the north of you.</value>
        </item>
        <item>
          <key>dimsouth</key>
          <value>There is a bookshelf in front of you.</value>
        </item>
        <item>
          <key>dimwest</key>
          <value>There is a bookshelf to the south, and to the north of you.</value>
        </item>
        <item>
          <key>brightnorth</key>
          <value>The bright light hurts your eyes. There is a bookshelf in front of you.</value>
        </item>
        <item>
          <key>brighteast</key>
          <value>The bright light hurts your eyes. There is a bookshelf to the south, and to the north of you.</value>
        </item>
        <item>
          <key>brightsouth</key>
          <value>The bright light hurts your eyes. There is a bookshelf in front of you.</value>
        </item>
        <item>
          <key>brightwest</key>
          <value>The bright light hurts your eyes. There is a bookshelf to the south, and to the north of you.</value>
        </item>
      </descriptions>
      <description type="script">
        PrintRoomDesc (False)
      </description>
      <exit name="West194" alias="west" to="defaultroom">
        <inherit name="westdirection" />
        <runscript />
        <visible />
        <script type="script">
          MoveAndFace (library69, 3)
        </script>
      </exit>
      <exit name="East195" alias="east" to="defaultroom">
        <inherit name="eastdirection" />
        <runscript />
        <script type="script">
          MoveAndFace (library81, 1)
        </script>
      </exit>
    </object>
    <object name="library74">
      <inherit name="editor_room" />
      <usedefaultprefix />
      <descriptions type="stringdictionary">
        <item>
          <key>darknorth</key>
          <value>You cannot see anything. You feel as if you have faded into the darkness. </value>
        </item>
        <item>
          <key>darkeast</key>
          <value>You cannot see anything. You feel as if you have faded into the darkness. You can feel a bookshelf in front of you.</value>
        </item>
        <item>
          <key>darksouth</key>
          <value>You cannot see anything. You feel as if you have faded into the darkness. You can feel a bookshelf in front of you.</value>
        </item>
        <item>
          <key>darkwest</key>
          <value>You cannot see anything. You feel as if you have faded into the darkness.</value>
        </item>
        <item>
          <key>dimnorth</key>
          <value>There is a bookshelf to the east of you, the path continues to the west, and to the north.</value>
        </item>
        <item>
          <key>dimeast</key>
          <value>There is a bookshelf in front of you, and to the south of you.</value>
        </item>
        <item>
          <key>dimsouth</key>
          <value>There is a bookshelf in front of you, and to the east of you. </value>
        </item>
        <item>
          <key>dimwest</key>
          <value>There is a bookshelf to the south of you. The path continues forwards.</value>
        </item>
        <item>
          <key>brightnorth</key>
          <value>There is a bookshelf to the east of you, the path continues to the west, and to the north.</value>
        </item>
        <item>
          <key>brighteast</key>
          <value>There is a bookshelf in front of you, and to the south of you. The path continues to the north of you.</value>
        </item>
        <item>
          <key>brightsouth</key>
          <value>There is a bookshelf in front of you, and to the east of you. The path continues to the west.</value>
        </item>
        <item>
          <key>brightwest</key>
          <value>There is a bookshelf to the south of you. The path continues forwards.</value>
        </item>
      </descriptions>
      <description type="script">
        PrintRoomDesc (False)
      </description>
      <exit name="West195" alias="west" to="defaultroom">
        <inherit name="westdirection" />
        <runscript />
        <visible />
        <script type="script">
          MoveAndFace (library70, 3)
        </script>
      </exit>
      <exit name="North208" alias="north" to="defaultroom">
        <inherit name="northdirection" />
        <runscript />
        <script type="script">
          MoveAndFace (library75, 0)
        </script>
      </exit>
    </object>
    <object name="library75">
      <inherit name="editor_room" />
      <usedefaultprefix />
      <descriptions type="stringdictionary">
        <item>
          <key>darknorth</key>
          <value>You cannot see anything. You feel as if you have faded into the darkness. </value>
        </item>
        <item>
          <key>darkeast</key>
          <value>You cannot see anything. You feel as if you have faded into the darkness. You can feel a bookshelf in front of you.</value>
        </item>
        <item>
          <key>darksouth</key>
          <value>You cannot see anything. You feel as if you have faded into the darkness.</value>
        </item>
        <item>
          <key>darkwest</key>
          <value>You cannot see anything. You feel as if you have faded into the darkness.</value>
        </item>
        <item>
          <key>dimnorth</key>
          <value>There is a bookshelf to the east of you. There is a step to the west of you that looks different than the others, less sturdy almost.</value>
        </item>
        <item>
          <key>dimeast</key>
          <value>There is a bookshelf in front of you.</value>
        </item>
        <item>
          <key>dimsouth</key>
          <value>There is a bookshelf to the east of you.</value>
        </item>
        <item>
          <key>dimwest</key>
          <value>There is a bookshelf a step forwards that looks different than the others. It looks unstable.</value>
        </item>
        <item>
          <key>brightnorth</key>
          <value>There is a bookshelf to the east of you. There is a step to the west of you that looks different than the others, less sturdy almost.</value>
        </item>
        <item>
          <key>brighteast</key>
          <value>There is a bookshelf in front of you. The path continues to the south or north of you.</value>
        </item>
        <item>
          <key>brightsouth</key>
          <value>There is a bookshelf to the east of you. The path continues forwards.</value>
        </item>
        <item>
          <key>brightwest</key>
          <value>There is a bookshelf a step forwards that looks different than the others. It looks unstable. The path continues to the south and north of you.</value>
        </item>
      </descriptions>
      <description type="script"><![CDATA[
        if (player.facing_num = 3 and library71.collapsed and lantern.light_level > 0) {
          msg ("The bookshelf a step forwards has collapsed and is blocking you from moving forward. The path continues to the south and north of you.")
        }
        else if (player.facing_num = 0 and library71.collapsed) {
          if (lantern.light_level = 2) {
            msg ("There is a bookshelf to the east of you and a collapsed bookshelf to the west. The path continues to the south and north of you.")
          }
          else if (lantern.light_level = 1) {
            msg ("There is a bookshelf to the east of you and a collapsed bookshelf to the west.")
          }
        }
        else {
          PrintRoomDesc (False)
        }
      ]]></description>
      <exit name="West196" alias="west" to="defaultroom">
        <inherit name="westdirection" />
        <runscript />
        <visible />
        <script type="script">
          msg ("You accidentally stumble into the bookshelf. The wood on the shelf is rotting away, causing it to collapse from the added weight, and falls on top of you. The lantern is knocked out of your hands, and rolls away leaking oil out onto the floor. You think you hear something running towards you, and hold your breath. The silence rings in your ears, and you realize you dont hear anything anymore. It must have been your imagination. You pull yourself out of the rubble, stand up, walk over to your lantern and pick it up.")
          JumpScare
          player.parent = library74
          lantern.fuel_level = lantern.fuel_level / 2
          North204.visible = false
          West196.visible = false
          library71.collapsed = true
        </script>
      </exit>
      <exit name="South210" alias="south" to="defaultroom">
        <inherit name="southdirection" />
        <runscript />
        <script type="script">
          MoveAndFace (library74, 2)
        </script>
      </exit>
      <exit name="North209" alias="north" to="defaultroom">
        <inherit name="northdirection" />
        <runscript />
        <script type="script">
          MoveAndFace (library76, 0)
        </script>
      </exit>
    </object>
    <object name="library76">
      <inherit name="editor_room" />
      <usedefaultprefix />
      <descriptions type="stringdictionary">
        <item>
          <key>darknorth</key>
          <value>You cannot see anything. You feel as if you have faded into the darkness. </value>
        </item>
        <item>
          <key>darkeast</key>
          <value>You cannot see anything. You feel as if you have faded into the darkness.</value>
        </item>
        <item>
          <key>darksouth</key>
          <value>You cannot see anything. You feel as if you have faded into the darkness.</value>
        </item>
        <item>
          <key>darkwest</key>
          <value>You cannot see anything. You feel as if you have faded into the darkness. You can feel a bookshelf in front of you.</value>
        </item>
        <item>
          <key>dimnorth</key>
          <value>There is a bookshelf to the west of you. There is a grey book on the shelf that catches your eye, it is entitled The King and His Servants. The path continues forwards and to the east.</value>
        </item>
        <item>
          <key>dimeast</key>
          <value>You are at a fork in the path. The path continues forwards, to the south, and to the north of you.</value>
        </item>
        <item>
          <key>dimsouth</key>
          <value>There is a bookshelf to the west of you. There is a grey book on the shelf that catches your eye, it is entitled The King and His Servants. The path continues forwards and to the east.</value>
        </item>
        <item>
          <key>dimwest</key>
          <value>There is a bookshelf in front of you. There is a grey book on the shelf that catches your eye, it is entitled The King and His Servants. The path continues to the south, and the north.</value>
        </item>
        <item>
          <key>brightnorth</key>
          <value>There is a bookshelf to the west of you. There is a grey book on the shelf that catches your eye, it is entitled The King and His Servants.  The path continues forwards and to the east.</value>
        </item>
        <item>
          <key>brighteast</key>
          <value>You are at a fork in the path. The path continues forwards, to the south, and to the north of you.</value>
        </item>
        <item>
          <key>brightsouth</key>
          <value>There is a bookshelf to the west of you. There is a grey book on the shelf that catches your eye, it is entitled The King and His Servants. The path continues forwards and to the east.</value>
        </item>
        <item>
          <key>brightwest</key>
          <value>There is a bookshelf in front of you. There is a grey book on the shelf that catches your eye, it is entitled The King and His Servants. The path continues to the south, and the north.</value>
        </item>
      </descriptions>
      <description type="script">
        PrintRoomDesc (False)
      </description>
      <exit name="South211" alias="south" to="defaultroom">
        <inherit name="southdirection" />
        <runscript />
        <script type="script">
          MoveAndFace (library75, 2)
        </script>
      </exit>
      <exit name="East198" alias="east" to="defaultroom">
        <inherit name="eastdirection" />
        <runscript />
        <script type="script">
          MoveAndFace (library82, 1)
        </script>
      </exit>
      <exit name="North210" alias="north" to="defaultroom">
        <inherit name="northdirection" />
        <runscript />
        <script type="script">
          MoveAndFace (library77, 0)
        </script>
      </exit>
    </object>
    <object name="library77">
      <inherit name="editor_room" />
      <usedefaultprefix />
      <descriptions type="stringdictionary">
        <item>
          <key>darknorth</key>
          <value>You cannot see anything. You feel as if you have faded into the darkness. </value>
        </item>
        <item>
          <key>darkeast</key>
          <value>You cannot see anything. You feel as if you have faded into the darkness.</value>
        </item>
        <item>
          <key>darksouth</key>
          <value>You cannot see anything. You feel as if you have faded into the darkness.</value>
        </item>
        <item>
          <key>darkwest</key>
          <value>You cannot see anything. You feel as if you have faded into the darkness. You can feel a bookshelf in front of you.</value>
        </item>
        <item>
          <key>dimnorth</key>
          <value>There is a bookshelf to the west of you. The path continues forwards, and to the east.</value>
        </item>
        <item>
          <key>dimeast</key>
          <value>You are at a fork in the path. The path continues forwards, to the south, and to the north.</value>
        </item>
        <item>
          <key>dimsouth</key>
          <value>There is a bookshelf to the west of you. The path continues forwards, and to the east. </value>
        </item>
        <item>
          <key>dimwest</key>
          <value>There is a bookshelf in front of you. The path continues to the south and north of you.</value>
        </item>
        <item>
          <key>brightnorth</key>
          <value>There is a bookshelf to the west of you. The path continues forwards, and to the east.</value>
        </item>
        <item>
          <key>brighteast</key>
          <value>You are at a fork in the path. The path continues forwards, to the south, and to the north.</value>
        </item>
        <item>
          <key>brightsouth</key>
          <value>There is a bookshelf to the west of you. The path continues forwards, and to the east. </value>
        </item>
        <item>
          <key>brightwest</key>
          <value>There is a bookshelf in front of you. The path continues to the south and north of you. </value>
        </item>
      </descriptions>
      <description type="script">
        PrintRoomDesc (False)
      </description>
      <exit name="South212" alias="south" to="defaultroom">
        <inherit name="southdirection" />
        <runscript />
        <script type="script">
          MoveAndFace (library76, 2)
        </script>
      </exit>
      <exit name="East199" alias="east" to="defaultroom">
        <inherit name="eastdirection" />
        <runscript />
        <script type="script">
          MoveAndFace (library83, 1)
        </script>
      </exit>
      <exit name="North211" alias="north" to="defaultroom">
        <inherit name="northdirection" />
        <runscript />
        <script type="script">
          MoveAndFace (library78, 0)
        </script>
      </exit>
    </object>
    <object name="library78">
      <inherit name="editor_room" />
      <usedefaultprefix />
      <descriptions type="stringdictionary">
        <item>
          <key>darknorth</key>
          <value>You cannot see anything. You feel as if you have faded into the darkness. </value>
        </item>
        <item>
          <key>darkeast</key>
          <value>You cannot see anything. You feel as if you have faded into the darkness. You can feel a bookshelf in front of you.</value>
        </item>
        <item>
          <key>darksouth</key>
          <value>You cannot see anything. You feel as if you have faded into the darkness.</value>
        </item>
        <item>
          <key>darkwest</key>
          <value>You cannot see anything. You feel as if you have faded into the darkness. You can feel a bookshelf in front of you.</value>
        </item>
        <item>
          <key>dimnorth</key>
          <value>There is a bookshelf to the east and west of you. The path continues forwards.</value>
        </item>
        <item>
          <key>dimeast</key>
          <value>There is a bookshelf in front of you. The path continues to the north and south of you.</value>
        </item>
        <item>
          <key>dimsouth</key>
          <value>There is a bookshelf to the east and west of you. The path continues forwards.</value>
        </item>
        <item>
          <key>dimwest</key>
          <value>There is a bookshelf in front of you. The path continues to the north and south of you.</value>
        </item>
        <item>
          <key>brightnorth</key>
          <value>There is a bookshelf to the east and west of you. The path continues forwards.</value>
        </item>
        <item>
          <key>brighteast</key>
          <value>There is a bookshelf in front of you. The path continues to the north and south of you.</value>
        </item>
        <item>
          <key>brightsouth</key>
          <value>There is a bookshelf to the east and west of you. The path continues forwards.</value>
        </item>
        <item>
          <key>brightwest</key>
          <value>There is a bookshelf in front of you. The path continues to the north and south of you.</value>
        </item>
      </descriptions>
      <description type="script">
        PrintRoomDesc (False)
      </description>
      <exit name="South213" alias="south" to="defaultroom">
        <inherit name="southdirection" />
        <runscript />
        <script type="script">
          MoveAndFace (library77, 2)
        </script>
      </exit>
      <exit name="North212" alias="north" to="defaultroom">
        <inherit name="northdirection" />
        <runscript />
        <script type="script">
          MoveAndFace (library79, 0)
        </script>
      </exit>
    </object>
    <object name="library79">
      <inherit name="editor_room" />
      <usedefaultprefix />
      <descriptions type="stringdictionary">
        <item>
          <key>darknorth</key>
          <value>You cannot see anything. You feel as if you have faded into the darkness. </value>
        </item>
        <item>
          <key>darkeast</key>
          <value>You cannot see anything. You feel as if you have faded into the darkness. You can feel a bookshelf in front of you.</value>
        </item>
        <item>
          <key>darksouth</key>
          <value>You cannot see anything. You feel as if you have faded into the darkness.</value>
        </item>
        <item>
          <key>darkwest</key>
          <value>You cannot see anything. You feel as if you have faded into the darkness.</value>
        </item>
        <item>
          <key>dimnorth</key>
          <value>There is a bookshelf to the east of you. There is something on the floor a step forwards, but you cant tell what it is.</value>
        </item>
        <item>
          <key>dimeast</key>
          <value>There is a bookshelf in front of you. You notice something on the floor to the north of you, but you cant tell what it is. </value>
        </item>
        <item>
          <key>dimsouth</key>
          <value>There is a bookshelf to the east of you. The path continues forwards.</value>
        </item>
        <item>
          <key>dimwest</key>
          <value>You notice the ground to the north of you has something on it, but you cant tell what it is.</value>
        </item>
        <item>
          <key>brightnorth</key>
          <value>There is a bookshelf to the east of you. There is something on the floor a step forwards, but you cant tell what it is.</value>
        </item>
        <item>
          <key>brighteast</key>
          <value>There is a bookshelf in front of you. You notice something on the floor to the north of you, but you cant tell what it is. </value>
        </item>
        <item>
          <key>brightsouth</key>
          <value>There is a bookshelf to the east of you. The path continues forwards.</value>
        </item>
        <item>
          <key>brightwest</key>
          <value>You notice the ground to the north of you has something on it, but you cant tell what it is. The path continues forwards.</value>
        </item>
      </descriptions>
      <description type="script">
        PrintRoomDesc (False)
      </description>
      <exit name="West200" alias="west" to="defaultroom">
        <inherit name="westdirection" />
        <runscript />
        <visible />
        <script type="script">
          MoveAndFace (library72, 3)
        </script>
      </exit>
      <exit name="South214" alias="south" to="defaultroom">
        <inherit name="southdirection" />
        <runscript />
        <script type="script">
          MoveAndFace (library78, 2)
        </script>
      </exit>
      <exit name="North213" alias="north" to="defaultroom">
        <inherit name="northdirection" />
        <runscript />
        <script type="script">
          msg ("You step down on something oddly shaped, and look down at your feet to see a pile of human remains. You let out a scream, and stumble backwards.")
          msg ("Something pulls your leg out from under you. You fall so quickly that you do not have time to brace yourself, and break your fall with your face. Blood rushes from your nose as you are dragged across the floor by your ankles.")
          msg ("The creature lets out a screech, drops your legs and runs off.")
          msg ("You stand up, and wipe the blood off your face.")
          lantern.fuel_level = lantern.fuel_level - 10
          JumpScare
          player.parent = library77
          FaceSouth
        </script>
      </exit>
    </object>
    <object name="library80">
      <inherit name="editor_room" />
      <usedefaultprefix />
      <descriptions type="stringdictionary">
        <item>
          <key>darknorth</key>
          <value>TODO: implement this description</value>
        </item>
        <item>
          <key>darkeast</key>
          <value>TODO: implement this description</value>
        </item>
        <item>
          <key>darksouth</key>
          <value>TODO: implement this description</value>
        </item>
        <item>
          <key>darkwest</key>
          <value>TODO: implement this description</value>
        </item>
        <item>
          <key>dimnorth</key>
          <value>TODO: implement this description</value>
        </item>
        <item>
          <key>dimeast</key>
          <value>TODO: implement this description</value>
        </item>
        <item>
          <key>dimsouth</key>
          <value>TODO: implement this description</value>
        </item>
        <item>
          <key>dimwest</key>
          <value>TODO: implement this description</value>
        </item>
        <item>
          <key>brightnorth</key>
          <value>TODO: implement this description</value>
        </item>
        <item>
          <key>brighteast</key>
          <value>TODO: implement this description</value>
        </item>
        <item>
          <key>brightsouth</key>
          <value>TODO: implement this description</value>
        </item>
        <item>
          <key>brightwest</key>
          <value>TODO: implement this description</value>
        </item>
      </descriptions>
      <description type="script">
        PrintRoomDesc (False)
      </description>
      <exit name="South215" alias="south" to="defaultroom">
        <inherit name="southdirection" />
        <runscript />
        <script type="script">
          MoveAndFace (library79, 2)
        </script>
      </exit>
    </object>
    <object name="library81">
      <inherit name="editor_room" />
      <usedefaultprefix />
      <descriptions type="stringdictionary">
        <item>
          <key>darknorth</key>
          <value>You cannot see anything. You feel as if you have faded into the darkness. You can feel a bookshelf in front of you.</value>
        </item>
        <item>
          <key>darkeast</key>
          <value>You cannot see anything. You feel as if you have faded into the darkness.</value>
        </item>
        <item>
          <key>darksouth</key>
          <value>You cannot see anything. You feel as if you have faded into the darkness. You can feel a bookshelf in front of you.</value>
        </item>
        <item>
          <key>darkwest</key>
          <value>You cannot see anything. You feel as if you have faded into the darkness.</value>
        </item>
        <item>
          <key>dimnorth</key>
          <value>There is a bookshelf in front of you. The path continues to the west, and east of you.</value>
        </item>
        <item>
          <key>dimeast</key>
          <value>There is a bookshelf to the south, and to the north of you. The path continues forwards.</value>
        </item>
        <item>
          <key>dimsouth</key>
          <value>There is a bookshelf in front of you. The path continues to the west, and east of you.</value>
        </item>
        <item>
          <key>dimwest</key>
          <value>There is a bookshelf to the south, and to the north of you. The path continues forwards.</value>
        </item>
        <item>
          <key>brightnorth</key>
          <value>The bright light hurts your eyes. There is a bookshelf in front of you. The path continues to the west, and east of you.</value>
        </item>
        <item>
          <key>brighteast</key>
          <value>The bright light hurts your eyes. There is a bookshelf to the south, and to the north of you. The path continues forwards.</value>
        </item>
        <item>
          <key>brightsouth</key>
          <value>The bright light hurts your eyes. There is a bookshelf in front of you. The path continues to the west, and east of you.</value>
        </item>
        <item>
          <key>brightwest</key>
          <value>The bright light hurts your eyes. There is a bookshelf to the south, and to the north of you. The path continues forwards.</value>
        </item>
      </descriptions>
      <description type="script">
        PrintRoomDesc (False)
      </description>
      <exit name="West202" alias="west" to="defaultroom">
        <inherit name="westdirection" />
        <runscript />
        <visible />
        <script type="script">
          MoveAndFace (library73, 3)
        </script>
      </exit>
      <exit name="East203" alias="east" to="defaultroom">
        <inherit name="eastdirection" />
        <runscript />
        <script type="script">
          MoveAndFace (library84, 1)
        </script>
      </exit>
    </object>
    <object name="library82">
      <inherit name="editor_room" />
      <usedefaultprefix />
      <descriptions type="stringdictionary">
        <item>
          <key>darknorth</key>
          <value>You cannot see anything. You feel as if you have faded into the darkness. </value>
        </item>
        <item>
          <key>darkeast</key>
          <value>You cannot see anything. You feel as if you have faded into the darkness.</value>
        </item>
        <item>
          <key>darksouth</key>
          <value>You cannot see anything. You feel as if you have faded into the darkness. You can feel a bookshelf in front of you.</value>
        </item>
        <item>
          <key>darkwest</key>
          <value>You cannot see anything. You feel as if you have faded into the darkness.</value>
        </item>
        <item>
          <key>dimnorth</key>
          <value>You are at a fork in the path. The path continues forwards, to the west, and to the east.</value>
        </item>
        <item>
          <key>dimeast</key>
          <value>There is a bookshelf to the south of you. The path continues forwards, and to the north.</value>
        </item>
        <item>
          <key>dimsouth</key>
          <value>There is a bookshelf in front of you. The path continues to the west, and east of you.</value>
        </item>
        <item>
          <key>dimwest</key>
          <value>There is a bookshelf to the south of you. The path continues forwards and to the north.</value>
        </item>
        <item>
          <key>brightnorth</key>
          <value>The bright light hurts your eyes. You are at a fork in the path. The path continues forwards, to the west, and to the east.</value>
        </item>
        <item>
          <key>brighteast</key>
          <value>The bright light hurts your eyes. There is a bookshelf to the south of you. The path continues forwards, and to the north.</value>
        </item>
        <item>
          <key>brightsouth</key>
          <value>The bright light hurts your eyes. There is a bookshelf in front of you. The path continues to the west, and east of you.</value>
        </item>
        <item>
          <key>brightwest</key>
          <value>The bright light hurts your eyes. There is a bookshelf to the south of you. The path continues forwards and to the north.</value>
        </item>
      </descriptions>
      <description type="script">
        PrintRoomDesc (False)
      </description>
      <exit name="West203" alias="west" to="defaultroom">
        <inherit name="westdirection" />
        <runscript />
        <visible />
        <script type="script">
          MoveAndFace (library76, 3)
        </script>
      </exit>
      <exit name="East204" alias="east" to="defaultroom">
        <inherit name="eastdirection" />
        <runscript />
        <script type="script">
          MoveAndFace (library87, 1)
        </script>
      </exit>
      <exit name="North216" alias="north" to="defaultroom">
        <inherit name="northdirection" />
        <runscript />
        <script type="script">
          MoveAndFace (library83, 0)
        </script>
      </exit>
    </object>
    <object name="library83">
      <inherit name="editor_room" />
      <usedefaultprefix />
      <descriptions type="stringdictionary">
        <item>
          <key>darknorth</key>
          <value>You cannot see anything. You feel as if you have faded into the darkness. You can feel a bookshelf in front of you.</value>
        </item>
        <item>
          <key>darkeast</key>
          <value>You cannot see anything. You feel as if you have faded into the darkness.</value>
        </item>
        <item>
          <key>darksouth</key>
          <value>You cannot see anything. You feel as if you have faded into the darkness.</value>
        </item>
        <item>
          <key>darkwest</key>
          <value>You cannot see anything. You feel as if you have faded into the darkness.</value>
        </item>
        <item>
          <key>dimnorth</key>
          <value>There is a bookshelf in front of you. The path continues to the east, and west of you.</value>
        </item>
        <item>
          <key>dimeast</key>
          <value>There is a bookshelf to the north of you. The path continues forwards and to the south.</value>
        </item>
        <item>
          <key>dimsouth</key>
          <value>You are at a fork in the path. The path continues forwards, to the west, and to the east.</value>
        </item>
        <item>
          <key>dimwest</key>
          <value>There is a bookshelf to the north of you. The path continues forwards and to the south.</value>
        </item>
        <item>
          <key>brightnorth</key>
          <value>The bright light hurts your eyes. There is a bookshelf in front of you. The path continues to the east, and west of you.</value>
        </item>
        <item>
          <key>brighteast</key>
          <value>The bright light hurts your eyes. There is a bookshelf to the north of you. The path continues forwards and to the south.</value>
        </item>
        <item>
          <key>brightsouth</key>
          <value>The bright light hurts your eyes. You are at a fork in the path. The path continues forwards, to the west, and to the east.</value>
        </item>
        <item>
          <key>brightwest</key>
          <value>The bright light hurts your eyes. There is a bookshelf to the north of you. The path continues forwards and to the south.</value>
        </item>
      </descriptions>
      <description type="script">
        PrintRoomDesc (False)
      </description>
      <exit name="West204" alias="west" to="defaultroom">
        <inherit name="westdirection" />
        <runscript />
        <visible />
        <script type="script">
          MoveAndFace (library77, 3)
        </script>
      </exit>
      <exit name="South218" alias="south" to="defaultroom">
        <inherit name="southdirection" />
        <runscript />
        <script type="script">
          MoveAndFace (library82, 2)
        </script>
      </exit>
      <exit name="East205" alias="east" to="defaultroom">
        <inherit name="eastdirection" />
        <runscript />
        <script type="script">
          MoveAndFace (library88, 1)
        </script>
      </exit>
    </object>
    <object name="library84">
      <inherit name="editor_room" />
      <usedefaultprefix />
      <descriptions type="stringdictionary">
        <item>
          <key>darknorth</key>
          <value>You cannot see anything. You feel as if you have faded into the darkness. You can feel a bookshelf in front of you.</value>
        </item>
        <item>
          <key>darkeast</key>
          <value>You cannot see anything. You feel as if you have faded into the darkness.</value>
        </item>
        <item>
          <key>darksouth</key>
          <value>You cannot see anything. You feel as if you have faded into the darkness. You can feel a bookshelf in front of you.</value>
        </item>
        <item>
          <key>darkwest</key>
          <value>You cannot see anything. You feel as if you have faded into the darkness.</value>
        </item>
        <item>
          <key>dimnorth</key>
          <value>There is a bookshelf in front of you. The path continues to the east and west of you.</value>
        </item>
        <item>
          <key>dimeast</key>
          <value>There is a bookshelf to the north, and to the south of you. The path continues forwards.</value>
        </item>
        <item>
          <key>dimsouth</key>
          <value>There is a bookshelf in front of you. The path continues to the east and west of you.</value>
        </item>
        <item>
          <key>dimwest</key>
          <value>There is a bookshelf to the north, and to the south of you. The path continues forwards.</value>
        </item>
        <item>
          <key>brightnorth</key>
          <value>The bright light hurts your eyes. There is a bookshelf in front of you. The path continues to the east and west of you.</value>
        </item>
        <item>
          <key>brighteast</key>
          <value>The bright light hurts your eyes. There is a bookshelf to the north, and to the south of you. The path continues forwards.</value>
        </item>
        <item>
          <key>brightsouth</key>
          <value>The bright light hurts your eyes. There is a bookshelf in front of you. The path continues to the east and west of you.</value>
        </item>
        <item>
          <key>brightwest</key>
          <value>The bright light hurts your eyes. There is a bookshelf to the north, and to the south of you. The path continues forwards.</value>
        </item>
      </descriptions>
      <description type="script">
        PrintRoomDesc (False)
      </description>
      <exit name="West205" alias="west" to="defaultroom">
        <inherit name="westdirection" />
        <runscript />
        <visible />
        <script type="script">
          MoveAndFace (library81, 3)
        </script>
      </exit>
      <exit name="East206" alias="east" to="defaultroom">
        <inherit name="eastdirection" />
        <runscript />
        <script type="script">
          MoveAndFace (library93, 1)
        </script>
      </exit>
    </object>
    <object name="library86">
      <inherit name="editor_room" />
      <usedefaultprefix />
      <descriptions type="stringdictionary">
        <item>
          <key>darknorth</key>
          <value>You cannot see anything. You feel as if you have faded into the darkness. </value>
        </item>
        <item>
          <key>darkeast</key>
          <value>You cannot see anything. You feel as if you have faded into the darkness. You can feel a bookshelf in front of you.</value>
        </item>
        <item>
          <key>darksouth</key>
          <value>You cannot see anything. You feel as if you have faded into the darkness. You can feel a small table in front of you.</value>
        </item>
        <item>
          <key>darkwest</key>
          <value>You cannot see anything. You feel as if you have faded into the darkness. You can feel a bookshelf in front of you.</value>
        </item>
        <item>
          <key>dimnorth</key>
          <value>There is a bookshelf to the west, and to the east of you. The path continues forwards.</value>
        </item>
        <item>
          <key>dimeast</key>
          <value>There is a bookshelf in front of you, and a small tableto the south of you.</value>
        </item>
        <item>
          <key>dimsouth</key>
          <value>There is a small table in front of you. There is a bookshelf to the east, and west of you. This is a dead end.</value>
        </item>
        <item>
          <key>dimwest</key>
          <value>There is a bookshelf in front of you, and a small table to the south of you.</value>
        </item>
        <item>
          <key>brightnorth</key>
          <value>The bright light hurts your eyes. There is a bookshelf to the west, and to the east of you. The path continues forwards.</value>
        </item>
        <item>
          <key>brighteast</key>
          <value>The bright light hurts your eyes. There is a bookshelf in front of you, and a small table to the south of you.</value>
        </item>
        <item>
          <key>brightsouth</key>
          <value>The bright light hurts your eyes. There is a small table in front of you. There is a bookshelf to the east, and west of you. This is a dead end.</value>
        </item>
        <item>
          <key>brightwest</key>
          <value>The bright light hurts your eyes. There is a bookshelf in front of you, and a small table to the south of you.</value>
        </item>
      </descriptions>
      <description type="script"><![CDATA[
        PrintRoomDesc (False)
        if (not oil10.parent = null and lantern.light_level > 0) {
          if (player.facing_num = 2) {
            msg ("There is a cask of oil sitting on the table in front of you.")
          }
          else if (player.facing_num <> 0) {
            msg ("There is a cask of oil sitting on the table to the south.")
          }
        }
      ]]></description>
      <exit name="North220" alias="north" to="defaultroom">
        <inherit name="northdirection" />
        <runscript />
        <script type="script">
          MoveAndFace (library87, 0)
        </script>
      </exit>
      <object name="oil10">
        <inherit name="editor_object" />
        <alt type="stringlist">
          <value>cask</value>
        </alt>
        <alias>oil</alias>
        <scenery />
        <feature_usegive />
        <take type="script">
          GetOil (oil10)
        </take>
        <use type="script">
          GetOil (oil10)
        </use>
      </object>
    </object>
    <object name="library87">
      <inherit name="editor_room" />
      <usedefaultprefix />
      <descriptions type="stringdictionary">
        <item>
          <key>darknorth</key>
          <value>You cannot see anything. You feel as if you have faded into the darkness. </value>
        </item>
        <item>
          <key>darkeast</key>
          <value>You cannot see anything. You feel as if you have faded into the darkness. You can feel a bookshelf in front of you.</value>
        </item>
        <item>
          <key>darksouth</key>
          <value>You cannot see anything. You feel as if you have faded into the darkness.</value>
        </item>
        <item>
          <key>darkwest</key>
          <value>You cannot see anything. You feel as if you have faded into the darkness.</value>
        </item>
        <item>
          <key>dimnorth</key>
          <value>There is a bookshelf to the east of you. The path continues forwards.</value>
        </item>
        <item>
          <key>dimeast</key>
          <value>There is a bookshelf in front of you. The path continues to the south, and north of you.</value>
        </item>
        <item>
          <key>dimsouth</key>
          <value>There is a bookshelf to the east of you. The path continues forwards, there seems to be a small table a few steps forwards.</value>
        </item>
        <item>
          <key>dimwest</key>
          <value>You are at a fork in the road. The path continues forwards, to the south, and to the north.</value>
        </item>
        <item>
          <key>brightnorth</key>
          <value>The bright light hurts your eyes. There is a bookshelf to the east of you. The path continues forwards. </value>
        </item>
        <item>
          <key>brighteast</key>
          <value>The bright light hurts your eyes. There is a bookshelf in front of you. The path continues to the south, and north of you.</value>
        </item>
        <item>
          <key>brightsouth</key>
          <value>The bright light hurts your eyes. There is a bookshelf to the east of you. The path continues forwards, there seems to be a small table a few steps forwards.</value>
        </item>
        <item>
          <key>brightwest</key>
          <value>The bright light hurts your eyes. You are at a fork in the road. The path continues forwards, to the south, and to the north.</value>
        </item>
      </descriptions>
      <description type="script">
        PrintRoomDesc (False)
      </description>
      <exit name="West208" alias="west" to="defaultroom">
        <inherit name="westdirection" />
        <runscript />
        <visible />
        <script type="script">
          MoveAndFace (library82, 3)
        </script>
      </exit>
      <exit name="South222" alias="south" to="defaultroom">
        <inherit name="southdirection" />
        <runscript />
        <script type="script">
          MoveAndFace (library86, 2)
        </script>
      </exit>
      <exit name="North221" alias="north" to="defaultroom">
        <inherit name="northdirection" />
        <runscript />
        <script type="script">
          MoveAndFace (library88, 0)
        </script>
      </exit>
    </object>
    <object name="library88">
      <inherit name="editor_room" />
      <usedefaultprefix />
      <descriptions type="stringdictionary">
        <item>
          <key>darknorth</key>
          <value>You cannot see anything. You feel as if you have faded into the darkness. </value>
        </item>
        <item>
          <key>darkeast</key>
          <value>You cannot see anything. You feel as if you have faded into the darkness. You can feel a bookshelf in front of you.</value>
        </item>
        <item>
          <key>darksouth</key>
          <value>You cannot see anything. You feel as if you have faded into the darkness.</value>
        </item>
        <item>
          <key>darkwest</key>
          <value>You cannot see anything. You feel as if you have faded into the darkness.</value>
        </item>
        <item>
          <key>dimnorth</key>
          <value>There is a bookshelf to the east of you. The path continues forwards, and to the west.</value>
        </item>
        <item>
          <key>dimeast</key>
          <value>There is a bookshelf in front of you. The path continues to the south, and the north.</value>
        </item>
        <item>
          <key>dimsouth</key>
          <value>There is a bookshelf to the east of you. The path continues forwards, and to the west of you.</value>
        </item>
        <item>
          <key>dimwest</key>
          <value>You are at a fork in the path. The path continues forwards, to the south, and to the north.</value>
        </item>
        <item>
          <key>brightnorth</key>
          <value>The bright light hurts your eyes. There is a bookshelf to the east of you. The path continues forwards, and to the west.</value>
        </item>
        <item>
          <key>brighteast</key>
          <value>The bright light hurts your eyes. There is a bookshelf in front of you. The path continues to the south, and the north.</value>
        </item>
        <item>
          <key>brightsouth</key>
          <value>The bright light hurts your eyes. There is a bookshelf to the east of you. The path continues forwards, and to the west of you.</value>
        </item>
        <item>
          <key>brightwest</key>
          <value>The bright light hurts your eyes. You are at a fork in the path. The path continues forwards, to the south, and to the north.</value>
        </item>
      </descriptions>
      <description type="script">
        PrintRoomDesc (False)
      </description>
      <exit name="West209" alias="west" to="defaultroom">
        <inherit name="westdirection" />
        <runscript />
        <visible />
        <script type="script">
          MoveAndFace (library83, 3)
        </script>
      </exit>
      <exit name="South223" alias="south" to="defaultroom">
        <inherit name="southdirection" />
        <runscript />
        <script type="script">
          MoveAndFace (library87, 2)
        </script>
      </exit>
      <exit name="North222" alias="north" to="defaultroom">
        <inherit name="northdirection" />
        <runscript />
        <script type="script">
          MoveAndFace (library89, 0)
        </script>
      </exit>
    </object>
    <object name="library89">
      <inherit name="editor_room" />
      <usedefaultprefix />
      <descriptions type="stringdictionary">
        <item>
          <key>darknorth</key>
          <value>You cannot see anything. You feel as if you have faded into the darkness. </value>
        </item>
        <item>
          <key>darkeast</key>
          <value>You cannot see anything. You feel as if you have faded into the darkness. </value>
        </item>
        <item>
          <key>darksouth</key>
          <value>You cannot see anything. You feel as if you have faded into the darkness.</value>
        </item>
        <item>
          <key>darkwest</key>
          <value>You cannot see anything. You feel as if you have faded into the darkness. You can feel a bookshelf in front of you.</value>
        </item>
        <item>
          <key>dimnorth</key>
          <value>There is a bookshelf to the west of you, the path continues forwards and to the east.</value>
        </item>
        <item>
          <key>dimeast</key>
          <value>You are at a fork in the path. The path continues forwards, to the south, and to the north.</value>
        </item>
        <item>
          <key>dimsouth</key>
          <value>There is a bookshelf to the west of you. The path continues forwards, and north of you.</value>
        </item>
        <item>
          <key>dimwest</key>
          <value>There is a bookshelf in front of you. The path continues to the south, and north of you.</value>
        </item>
        <item>
          <key>brightnorth</key>
          <value>The bright light hurts your eyes, you are straining through the pain to see. There is a bookshelf to the west of you.</value>
        </item>
        <item>
          <key>brighteast</key>
          <value>The bright light hurts your eyes, you are straining through the pain to see. You are at a fork in the path.</value>
        </item>
        <item>
          <key>brightsouth</key>
          <value>The bright light hurts your eyes, you are straining through the pain to see. There is a bookshelf to the west of you.</value>
        </item>
        <item>
          <key>brightwest</key>
          <value>The bright light hurts your eyes, you are straining through the pain to see. There is a bookshelf in front of you.</value>
        </item>
      </descriptions>
      <description type="script">
        PrintRoomDesc (False)
      </description>
      <exit name="South224" alias="south" to="defaultroom">
        <inherit name="southdirection" />
        <runscript />
        <script type="script">
          MoveAndFace (library88, 2)
        </script>
      </exit>
      <exit name="East211" alias="east" to="defaultroom">
        <inherit name="eastdirection" />
        <runscript />
        <script type="script">
          MoveAndFace (library94, 1)
        </script>
      </exit>
      <exit name="North223" alias="north" to="defaultroom">
        <inherit name="northdirection" />
        <runscript />
        <script type="script">
          MoveAndFace (library90, 0)
        </script>
      </exit>
    </object>
    <object name="library90">
      <inherit name="editor_room" />
      <usedefaultprefix />
      <descriptions type="stringdictionary">
        <item>
          <key>darknorth</key>
          <value>You cannot see anything. You feel as if you have faded into the darkness. </value>
        </item>
        <item>
          <key>darkeast</key>
          <value>You cannot see anything. You feel as if you have faded into the darkness. You can feel a bookshelf in front of you.</value>
        </item>
        <item>
          <key>darksouth</key>
          <value>You cannot see anything. You feel as if you have faded into the darkness.</value>
        </item>
        <item>
          <key>darkwest</key>
          <value>You cannot see anything. You feel as if you have faded into the darkness. You can feel a bookshelf in front of you.</value>
        </item>
        <item>
          <key>dimnorth</key>
          <value>There is a bookshelf to the east, and to the west of you. The path continues forwards.</value>
        </item>
        <item>
          <key>dimeast</key>
          <value>There is a bookshelf in front of you. The path continues to the south, and north of you.</value>
        </item>
        <item>
          <key>dimsouth</key>
          <value>There is a bookshelf to the east, and to the west of you. The path continues forwards.</value>
        </item>
        <item>
          <key>dimwest</key>
          <value>There is a bookshelf in front of you. The path continues to the south, and north of you.</value>
        </item>
        <item>
          <key>brightnorth</key>
          <value>The bright light hurts your eyes, you are straining through the pain to see. There is a bookshelf to the east, and to the west of you. </value>
        </item>
        <item>
          <key>brighteast</key>
          <value>The bright light hurts your eyes, you are straining through the pain to see. There is a bookshelf in front of you.</value>
        </item>
        <item>
          <key>brightsouth</key>
          <value>The bright light hurts your eyes, you are straining through the pain to see. There is a bookshelf to the east, and to the west of you. </value>
        </item>
        <item>
          <key>brightwest</key>
          <value>The bright light hurts your eyes, you are straining through the pain to see. There is a bookshelf in front of you.</value>
        </item>
      </descriptions>
      <description type="script">
        PrintRoomDesc (False)
      </description>
      <exit name="South225" alias="south" to="defaultroom">
        <inherit name="southdirection" />
        <runscript />
        <script type="script">
          MoveAndFace (library89, 2)
        </script>
      </exit>
      <exit name="North224" alias="north" to="defaultroom">
        <inherit name="northdirection" />
        <runscript />
        <script type="script">
          MoveAndFace (library91, 0)
        </script>
      </exit>
    </object>
    <object name="library91">
      <inherit name="editor_room" />
      <usedefaultprefix />
      <descriptions type="stringdictionary">
        <item>
          <key>darknorth</key>
          <value>You cannot see anything. You feel as if you have faded into the darkness. </value>
        </item>
        <item>
          <key>darkeast</key>
          <value>You cannot see anything. You feel as if you have faded into the darkness. You can feel a bookshelf in front of you.</value>
        </item>
        <item>
          <key>darksouth</key>
          <value>You cannot see anything. You feel as if you have faded into the darkness.</value>
        </item>
        <item>
          <key>darkwest</key>
          <value>You cannot see anything. You feel as if you have faded into the darkness. You can feel a bookshelf in front of you.</value>
        </item>
        <item>
          <key>dimnorth</key>
          <value>There is a bookshelf to the east, and to the west of you. There is a dark green book laying open on the shelf to the east. It seems to be talking about eternal life, potions, spells, and characteristics of potential candidates for the aforementioned things. The path continues forwards.</value>
        </item>
        <item>
          <key>dimeast</key>
          <value>There is a bookshelf in front of you. There is a dark green book laying open on the shelf. It seems to be talking about eternal life, potions, spells, and characteristics of potential candidates for the aforementioned things. The path continues to the north, and to the south of you.</value>
        </item>
        <item>
          <key>dimsouth</key>
          <value>There is a bookshelf to the east, and to the west of you. There is a dark green book laying open on the shelf to the east. It seems to be talking about eternal life, potions, spells, and characteristics of potential candidates for the aforementioned things. The path continues forwards.</value>
        </item>
        <item>
          <key>dimwest</key>
          <value>There is a bookshelf in front of you. The path continues to the north, and to the south of you.</value>
        </item>
        <item>
          <key>brightnorth</key>
          <value>The bright light hurts your eyes, you are straining through the pain to see. There is a bookshelf to the east, and to the west of you. </value>
        </item>
        <item>
          <key>brighteast</key>
          <value>The bright light hurts your eyes, you are straining through the pain to see. There is a bookshelf in front of you. </value>
        </item>
        <item>
          <key>brightsouth</key>
          <value>The bright light hurts your eyes, you are straining through the pain to see. There is a bookshelf to the east, and to the west of you. </value>
        </item>
        <item>
          <key>brightwest</key>
          <value>The bright light hurts your eyes, you are straining through the pain to see. There is a bookshelf in front of you. </value>
        </item>
      </descriptions>
      <description type="script">
        PrintRoomDesc (False)
      </description>
      <exit name="South226" alias="south" to="defaultroom">
        <inherit name="southdirection" />
        <runscript />
        <script type="script">
          MoveAndFace (library90, 2)
        </script>
      </exit>
      <exit name="North225" alias="north" to="defaultroom">
        <inherit name="northdirection" />
        <runscript />
        <script type="script">
          MoveAndFace (library92, 0)
        </script>
      </exit>
    </object>
    <object name="library92">
      <inherit name="editor_room" />
      <usedefaultprefix />
      <descriptions type="stringdictionary">
        <item>
          <key>darknorth</key>
          <value>You cannot see anything. You feel as if you have faded into the darkness. </value>
        </item>
        <item>
          <key>darkeast</key>
          <value>You cannot see anything. You feel as if you have faded into the darkness.</value>
        </item>
        <item>
          <key>darksouth</key>
          <value>You cannot see anything. You feel as if you have faded into the darkness.</value>
        </item>
        <item>
          <key>darkwest</key>
          <value>You cannot see anything. You feel as if you have faded into the darkness. You can feel a bookshelf in front of you.</value>
        </item>
        <item>
          <key>dimnorth</key>
          <value>There is a bookshelf to the west of you. The path continues forwards and to the east.</value>
        </item>
        <item>
          <key>dimeast</key>
          <value>You are at a fork in the road. The path continues forwards, to the north, and to the south.</value>
        </item>
        <item>
          <key>dimsouth</key>
          <value>There is a bookshelf to the west of you. The path continues forwards, and to the east of you.</value>
        </item>
        <item>
          <key>dimwest</key>
          <value>There is a bookshelf in front of you. The path continues to the south, and to the north of you.</value>
        </item>
        <item>
          <key>brightnorth</key>
          <value>The bright light hurts your eyes, you are straining through the pain to see. There is a bookshelf to the west of you.</value>
        </item>
        <item>
          <key>brighteast</key>
          <value>The bright light hurts your eyes, you are straining through the pain to see. You are at a fork in the road.</value>
        </item>
        <item>
          <key>brightsouth</key>
          <value>The bright light hurts your eyes, you are straining through the pain to see. There is a bookshelf to the west of you. </value>
        </item>
        <item>
          <key>brightwest</key>
          <value>The bright light hurts your eyes, you are straining through the pain to see. There is a bookshelf in front of you. </value>
        </item>
      </descriptions>
      <description type="script">
        PrintRoomDesc (False)
      </description>
      <exit name="South227" alias="south" to="defaultroom">
        <inherit name="southdirection" />
        <runscript />
        <script type="script">
          MoveAndFace (library91, 2)
        </script>
      </exit>
      <exit name="East214" alias="east" to="defaultroom">
        <inherit name="eastdirection" />
        <runscript />
        <script type="script">
          MoveAndFace (library95, 1)
        </script>
      </exit>
      <exit name="North226" alias="north" to="defaultroom">
        <inherit name="northdirection" />
        <runscript />
        <script type="script">
          MoveAndFace (library93, 0)
        </script>
      </exit>
    </object>
    <object name="library93">
      <inherit name="editor_room" />
      <usedefaultprefix />
      <descriptions type="stringdictionary">
        <item>
          <key>darknorth</key>
          <value>You cannot see anything. You feel as if you have faded into the darkness. You can feel a bookshelf in front of you.</value>
        </item>
        <item>
          <key>darkeast</key>
          <value>You cannot see anything. You feel as if you have faded into the darkness. You can feel a bookshelf in front of you.</value>
        </item>
        <item>
          <key>darksouth</key>
          <value>You cannot see anything. You feel as if you have faded into the darkness.</value>
        </item>
        <item>
          <key>darkwest</key>
          <value>You cannot see anything. You feel as if you have faded into the darkness.</value>
        </item>
        <item>
          <key>dimnorth</key>
          <value>There is a bookshelf in front of you, and to the east of you.</value>
        </item>
        <item>
          <key>dimeast</key>
          <value>There is a bookshelf in front of you, and to the north of you.</value>
        </item>
        <item>
          <key>dimsouth</key>
          <value>There is a bookshelf to the east of you. The path continues forwards, and to the west of you.</value>
        </item>
        <item>
          <key>dimwest</key>
          <value>There is a bookshelf to the north of you. The path continues forwards, and to the south.</value>
        </item>
        <item>
          <key>brightnorth</key>
          <value>The bright light hurts your eyes, you are straining through the pain to see. There is a bookshelf in front of you.</value>
        </item>
        <item>
          <key>brighteast</key>
          <value>The bright light hurts your eyes, you are straining through the pain to see. There is a bookshelf in front of you. </value>
        </item>
        <item>
          <key>brightsouth</key>
          <value>The bright light hurts your eyes, you are straining through the pain to see. There is a bookshelf to the east of you.</value>
        </item>
        <item>
          <key>brightwest</key>
          <value>The bright light hurts your eyes, you are straining through the pain to see. There is a bookshelf to the north of you. </value>
        </item>
      </descriptions>
      <description type="script">
        PrintRoomDesc (False)
      </description>
      <exit name="West214" alias="west" to="defaultroom">
        <inherit name="westdirection" />
        <runscript />
        <visible />
        <script type="script">
          MoveAndFace (library84, 3)
        </script>
      </exit>
      <exit name="South228" alias="south" to="defaultroom">
        <inherit name="southdirection" />
        <runscript />
        <script type="script">
          MoveAndFace (library92, 2)
        </script>
      </exit>
    </object>
    <object name="library94">
      <inherit name="editor_room" />
      <usedefaultprefix />
      <descriptions type="stringdictionary">
        <item>
          <key>darknorth</key>
          <value>You cannot see anything. You feel as if you have faded into the darkness. You can feel a bookshelf in front of you.</value>
        </item>
        <item>
          <key>darkeast</key>
          <value>You cannot see anything. You feel as if you have faded into the darkness.</value>
        </item>
        <item>
          <key>darksouth</key>
          <value>You cannot see anything. You feel as if you have faded into the darkness. You can feel a bookshelf in front of you.</value>
        </item>
        <item>
          <key>darkwest</key>
          <value>You cannot see anything. You feel as if you have faded into the darkness.</value>
        </item>
        <item>
          <key>dimnorth</key>
          <value>There is a bookshelf in front of you. The path continues to the east, and to the west.</value>
        </item>
        <item>
          <key>dimeast</key>
          <value>There is a bookshelf to the north, and the south of you. The path continues forwards.</value>
        </item>
        <item>
          <key>dimsouth</key>
          <value>There is a bookshelf in front of you. The path continues to the east, and to the west.</value>
        </item>
        <item>
          <key>dimwest</key>
          <value>There is a bookshelf to the north, and the south of you. The path continues forwards.</value>
        </item>
        <item>
          <key>brightnorth</key>
          <value>The bright light hurts your eyes, you are straining through the pain to see. There is a bookshelf in front of you. </value>
        </item>
        <item>
          <key>brighteast</key>
          <value>The bright light hurts your eyes, you are straining through the pain to see. There is a bookshelf to the north, and the south of you.</value>
        </item>
        <item>
          <key>brightsouth</key>
          <value>The bright light hurts your eyes, you are straining through the pain to see. There is a bookshelf in front of you. </value>
        </item>
        <item>
          <key>brightwest</key>
          <value>The bright light hurts your eyes, you are straining through the pain to see. There is a bookshelf to the north, and the south of you.</value>
        </item>
      </descriptions>
      <description type="script">
        PrintRoomDesc (False)
      </description>
      <exit name="West215" alias="west" to="defaultroom">
        <inherit name="westdirection" />
        <runscript />
        <visible />
        <script type="script">
          MoveAndFace (library89, 3)
        </script>
      </exit>
      <exit name="East216" alias="east" to="defaultroom">
        <inherit name="eastdirection" />
        <runscript />
        <script type="script">
          MoveAndFace (library96, 1)
        </script>
      </exit>
    </object>
    <object name="library95">
      <inherit name="editor_room" />
      <usedefaultprefix />
      <descriptions type="stringdictionary">
        <item>
          <key>darknorth</key>
          <value>You cannot see anything. You feel as if you have faded into the darkness. You can feel a bookshelf in front of you.</value>
        </item>
        <item>
          <key>darkeast</key>
          <value>You cannot see anything. You feel as if you have faded into the darkness.</value>
        </item>
        <item>
          <key>darksouth</key>
          <value>You cannot see anything. You feel as if you have faded into the darkness. You can feel a bookshelf in front of you.</value>
        </item>
        <item>
          <key>darkwest</key>
          <value>You cannot see anything. You feel as if you have faded into the darkness.</value>
        </item>
        <item>
          <key>dimnorth</key>
          <value>There is a bookshelf in front of you. The path continues to the east, and to the west.</value>
        </item>
        <item>
          <key>dimeast</key>
          <value>There is a bookshelf to the north, and to the south of you. The path continues forwards.</value>
        </item>
        <item>
          <key>dimsouth</key>
          <value>There is a bookshelf in front of you. The path continues to the east, and to the west.</value>
        </item>
        <item>
          <key>dimwest</key>
          <value>There is a bookshelf to the north, and to the south of you.The path continues forwards.</value>
        </item>
        <item>
          <key>brightnorth</key>
          <value>The bright light hurts your eyes, you are straining through the pain to see. There is a bookshelf in front of you. </value>
        </item>
        <item>
          <key>brighteast</key>
          <value>The bright light hurts your eyes, you are straining through the pain to see. There is a bookshelf to the north, and to the south of you.</value>
        </item>
        <item>
          <key>brightsouth</key>
          <value>The bright light hurts your eyes, you are straining through the pain to see. There is a bookshelf in front of you. </value>
        </item>
        <item>
          <key>brightwest</key>
          <value>The bright light hurts your eyes, you are straining through the pain to see. There is a bookshelf to the north, and to the south of you.</value>
        </item>
      </descriptions>
      <description type="script">
        PrintRoomDesc (False)
      </description>
      <exit name="West216" alias="west" to="defaultroom">
        <inherit name="westdirection" />
        <runscript />
        <visible />
        <script type="script">
          MoveAndFace (library92, 3)
        </script>
      </exit>
      <exit name="East217" alias="east" to="defaultroom">
        <inherit name="eastdirection" />
        <runscript />
        <script type="script">
          MoveAndFace (library98, 1)
        </script>
      </exit>
    </object>
    <object name="library96">
      <inherit name="editor_room" />
      <usedefaultprefix />
      <descriptions type="stringdictionary">
        <item>
          <key>darknorth</key>
          <value>You cannot see anything. You feel as if you have faded into the darkness. You can feel a small table in front of you.</value>
        </item>
        <item>
          <key>darkeast</key>
          <value>You cannot see anything. You feel as if you have faded into the darkness.</value>
        </item>
        <item>
          <key>darksouth</key>
          <value>You cannot see anything. You feel as if you have faded into the darkness. You can feel a bookshelf in front of you.</value>
        </item>
        <item>
          <key>darkwest</key>
          <value>You cannot see anything. You feel as if you have faded into the darkness.</value>
        </item>
        <item>
          <key>dimnorth</key>
          <value>There is a small table in front of you. The path continues to the east, and the west.</value>
        </item>
        <item>
          <key>dimeast</key>
          <value>There is a bookshelf to the south of you, and a small table to the north. The path continues forwards. </value>
        </item>
        <item>
          <key>dimsouth</key>
          <value>There is a bookshelf in front of you. The path continues to the east, and to the west.</value>
        </item>
        <item>
          <key>dimwest</key>
          <value>There is a bookshelf to the south, and a small table to the north. The path continues forwards.</value>
        </item>
        <item>
          <key>brightnorth</key>
          <value>The bright light hurts your eyes, you are straining through the pain to see. There is a small table in front of you. The path continues to the easy, and the west.</value>
        </item>
        <item>
          <key>brighteast</key>
          <value>The bright light hurts your eyes, you are straining through the pain to see. There is a bookshelf to the south of you, and a small table to the north. </value>
        </item>
        <item>
          <key>brightsouth</key>
          <value>The bright light hurts your eyes, you are straining through the pain to see. There is a bookshelf in front of you. </value>
        </item>
        <item>
          <key>brightwest</key>
          <value>The bright light hurts your eyes, you are straining through the pain to see. There is a bookshelf to the south, and a small table to the north.</value>
        </item>
      </descriptions>
      <description type="script"><![CDATA[
        PrintRoomDesc (False)
        if (not oil11.parent = null and lantern.light_level > 0) {
          if (player.facing_num = 0) {
            msg ("There is a cask of oil sitting on the table in front of you.")
          }
          else if (player.facing_num <> 2) {
            msg ("There is a cask of oil sitting on the table to the north.")
          }
        }
      ]]></description>
      <exit name="West217" alias="west" to="defaultroom">
        <inherit name="westdirection" />
        <runscript />
        <visible />
        <script type="script">
          MoveAndFace (library94, 3)
        </script>
      </exit>
      <exit name="East218" alias="east" to="defaultroom">
        <inherit name="eastdirection" />
        <runscript />
        <script type="script">
          MoveAndFace (library100, 1)
        </script>
      </exit>
      <object name="oil11">
        <inherit name="editor_object" />
        <alt type="stringlist">
          <value>cask</value>
        </alt>
        <alias>oil</alias>
        <scenery />
        <feature_usegive />
        <take type="script">
          GetOil (oil11)
        </take>
        <use type="script">
          GetOil (oil11)
        </use>
      </object>
    </object>
    <object name="library98">
      <inherit name="editor_room" />
      <usedefaultprefix />
      <descriptions type="stringdictionary">
        <item>
          <key>darknorth</key>
          <value>You cannot see anything. You feel as if you have faded into the darkness. </value>
        </item>
        <item>
          <key>darkeast</key>
          <value>You cannot see anything. You feel as if you have faded into the darkness.</value>
        </item>
        <item>
          <key>darksouth</key>
          <value>You cannot see anything. You feel as if you have faded into the darkness. You can feel a bookshelf in front of you.</value>
        </item>
        <item>
          <key>darkwest</key>
          <value>You cannot see anything. You feel as if you have faded into the darkness.</value>
        </item>
        <item>
          <key>dimnorth</key>
          <value>The ground a step in front of you looks unstable. The path continues forwards, to the east, and to north.</value>
        </item>
        <item>
          <key>dimeast</key>
          <value>There is a bookshelf to the south of you. The ground a step to the north of you looks unstable. The path continues forwards, and to the north.</value>
        </item>
        <item>
          <key>dimsouth</key>
          <value>There is a bookshelf in front of you. The path continues to the east, and to the west.</value>
        </item>
        <item>
          <key>dimwest</key>
          <value>There is a bookshelf to the south of you, and the ground a step to the north of you looks unstable. The path continues forwards.</value>
        </item>
        <item>
          <key>brightnorth</key>
          <value>The bright light hurts your eyes, you are straining through the pain to see. The ground a step in front of you looks unstable.</value>
        </item>
        <item>
          <key>brighteast</key>
          <value>The bright light hurts your eyes, you are straining through the pain to see. There is a bookshelf to the south of you. The ground a step to the north of you looks unstable. </value>
        </item>
        <item>
          <key>brightsouth</key>
          <value>The bright light hurts your eyes, you are straining through the pain to see. There is a bookshelf in front of you. </value>
        </item>
        <item>
          <key>brightwest</key>
          <value>The bright light hurts your eyes, you are straining through the pain to see. There is a bookshelf to the south of you, and the ground a step to the north of you looks unstable.</value>
        </item>
      </descriptions>
      <description type="script">
        PrintRoomDesc (False)
      </description>
      <exit name="West219" alias="west" to="defaultroom">
        <inherit name="westdirection" />
        <runscript />
        <visible />
        <script type="script">
          MoveAndFace (library95, 3)
        </script>
      </exit>
      <exit name="East220" alias="east" to="defaultroom">
        <inherit name="eastdirection" />
        <runscript />
        <script type="script">
          MoveAndFace (library103, 1)
        </script>
      </exit>
      <exit name="North232" alias="north" to="defaultroom">
        <inherit name="northdirection" />
        <runscript />
        <script type="script">
          msg ("Your foot gets caught in a hole in the ground, where the floor seems to have rotted away. You fall to the ground, and your lantern falls from your grasp. You lantern gets snuffed from the commotion, and leaks some oil onto the ground.")
          msg ("You hear a screech in the distance. You get your foot unstuck, and go retrieve your lantern.")
          lantern.light_level = 0
          lantern.fuel_level = lantern.fuel_level - 10
          FaceEast
          player.parent = library95
        </script>
      </exit>
    </object>
    <object name="library99">
      <inherit name="editor_room" />
      <usedefaultprefix />
      <descriptions type="stringdictionary">
        <item>
          <key>darknorth</key>
          <value>TODO: implement this description</value>
        </item>
        <item>
          <key>darkeast</key>
          <value>TODO: implement this description</value>
        </item>
        <item>
          <key>darksouth</key>
          <value>TODO: implement this description</value>
        </item>
        <item>
          <key>darkwest</key>
          <value>TODO: implement this description</value>
        </item>
        <item>
          <key>dimnorth</key>
          <value>TODO: implement this description</value>
        </item>
        <item>
          <key>dimeast</key>
          <value>TODO: implement this description</value>
        </item>
        <item>
          <key>dimsouth</key>
          <value>TODO: implement this description</value>
        </item>
        <item>
          <key>dimwest</key>
          <value>TODO: implement this description</value>
        </item>
        <item>
          <key>brightnorth</key>
          <value>TODO: implement this description</value>
        </item>
        <item>
          <key>brighteast</key>
          <value>TODO: implement this description</value>
        </item>
        <item>
          <key>brightsouth</key>
          <value>TODO: implement this description</value>
        </item>
        <item>
          <key>brightwest</key>
          <value>TODO: implement this description</value>
        </item>
      </descriptions>
      <description type="script">
        PrintRoomDesc (False)
      </description>
      <exit name="South234" alias="south" to="defaultroom">
        <inherit name="southdirection" />
        <runscript />
        <script type="script">
          MoveAndFace (library98, 2)
        </script>
      </exit>
      <exit name="East221" alias="east" to="defaultroom">
        <inherit name="eastdirection" />
        <runscript />
        <script type="script">
          MoveAndFace (library104, 1)
        </script>
      </exit>
    </object>
    <object name="library100">
      <inherit name="editor_room" />
      <usedefaultprefix />
      <descriptions type="stringdictionary">
        <item>
          <key>darknorth</key>
          <value>It is pitch black. You feel as if you have faded into the darkness. There is a bookshelf to the east of you.</value>
        </item>
        <item>
          <key>darkeast</key>
          <value>It is pitch black. You feel as if you have faded into the darkness. There is a bookshelf in front of you.</value>
        </item>
        <item>
          <key>darksouth</key>
          <value>You cannot see anything. You feel as if you have faded into the darkness. You can feel a bookshelf in front of you.</value>
        </item>
        <item>
          <key>darkwest</key>
          <value>It is pitch black. You feel as if you have faded into the darkness. There is a bookshelf to the south of you. </value>
        </item>
        <item>
          <key>dimnorth</key>
          <value>There is a bookshelf to the east of you. The path continues forwards, and to the west.</value>
        </item>
        <item>
          <key>dimeast</key>
          <value>There is a bookshelf in front of you, and to the south of you. The path continues to the north.</value>
        </item>
        <item>
          <key>dimsouth</key>
          <value>There is a bookshelf in front of you, and to the east of you. </value>
        </item>
        <item>
          <key>dimwest</key>
          <value>There is a bookshelf to the south of you. The path continues forwards, and to the north.</value>
        </item>
        <item>
          <key>brightnorth</key>
          <value>The light is so bright it makes your eyes burn, as if you were staring into the sun. It is so bright you cant see anything.</value>
        </item>
        <item>
          <key>brighteast</key>
          <value>The light is so bright it makes your eyes burn, as if you were staring into the sun. It is so bright you cant see anything.</value>
        </item>
        <item>
          <key>brightsouth</key>
          <value>The light is so bright it makes your eyes burn, as if you were staring into the sun. It is so bright you cant see anything.</value>
        </item>
        <item>
          <key>brightwest</key>
          <value>The light is so bright it makes your eyes burn, as if you were staring into the sun. It is so bright you cant see anything.</value>
        </item>
      </descriptions>
      <description type="script">
        PrintRoomDesc (False)
        if (not oil11.parent = null and lantern.light_level = 1) {
          if (player.facing_num = 0 or player.facing_num = 3) {
            msg ("There is a cask of oil sitting on the table to the northwest.")
          }
        }
      </description>
      <exit name="West221" alias="west" to="defaultroom">
        <inherit name="westdirection" />
        <runscript />
        <visible />
        <script type="script">
          MoveAndFace (library96, 3)
        </script>
      </exit>
      <exit name="North234" alias="north" to="defaultroom">
        <inherit name="northdirection" />
        <runscript />
        <script type="script">
          MoveAndFace (library101, 0)
        </script>
      </exit>
    </object>
    <object name="library101">
      <inherit name="editor_room" />
      <usedefaultprefix />
      <descriptions type="stringdictionary">
        <item>
          <key>darknorth</key>
          <value>It is pitch black, You feel as if you have faded into the darkness. There is a bookshelf to the east of you, and a small table to the west.</value>
        </item>
        <item>
          <key>darkeast</key>
          <value>It is pitch black. You feel as if you have faded into the darkness. There is a bookshelf in front of you.</value>
        </item>
        <item>
          <key>darksouth</key>
          <value>It is pitch black. You feel as if you have faded into the darkness. There is a bookshelf to the east of you, and a small table to the west.</value>
        </item>
        <item>
          <key>darkwest</key>
          <value>It is pitch black. You feel as if you have faded into the darkness. There is a small table in front of you. </value>
        </item>
        <item>
          <key>dimnorth</key>
          <value>There is a bookshelf to the east of you, and a small table to the west. The path continues forwards. </value>
        </item>
        <item>
          <key>dimeast</key>
          <value>There is a bookshelf in front of you. The path continues to the south, and north of you.</value>
        </item>
        <item>
          <key>dimsouth</key>
          <value>There is a bookshelf to the east of you, and a small table to the west. The path continues forwards.</value>
        </item>
        <item>
          <key>dimwest</key>
          <value>There is a small table in front of you. The path continues to the south, and the north. </value>
        </item>
        <item>
          <key>brightnorth</key>
          <value>The light is so bright it makes your eyes burn, as if you were staring into the sun. It is so bright you cant see anything.</value>
        </item>
        <item>
          <key>brighteast</key>
          <value>The light is so bright it makes your eyes burn, as if you were staring into the sun. It is so bright you cant see anything.</value>
        </item>
        <item>
          <key>brightsouth</key>
          <value>The light is so bright it makes your eyes burn, as if you were staring into the sun. It is so bright you cant see anything.</value>
        </item>
        <item>
          <key>brightwest</key>
          <value>The light is so bright it makes your eyes burn, as if you were staring into the sun. It is so bright you cant see anything.</value>
        </item>
      </descriptions>
      <description type="script"><![CDATA[
        PrintRoomDesc (False)
        if (not oil11.parent = null and lantern.light_level = 1) {
          if (player.facing_num = 3) {
            msg ("There is a cask of oil sitting on the table in front of you.")
          }
          else if (player.facing_num <> 1) {
            msg ("There is a cask of oil sitting on the table to the west.")
          }
        }
      ]]></description>
      <exit name="South236" alias="south" to="defaultroom">
        <inherit name="southdirection" />
        <runscript />
        <script type="script">
          MoveAndFace (library100, 2)
        </script>
      </exit>
      <exit name="North235" alias="north" to="defaultroom">
        <inherit name="northdirection" />
        <runscript />
        <script type="script">
          MoveAndFace (library102, 0)
        </script>
      </exit>
    </object>
    <object name="library102">
      <inherit name="editor_room" />
      <usedefaultprefix />
      <descriptions type="stringdictionary">
        <item>
          <key>darknorth</key>
          <value>It is pitch black. You feel as if you have faded into the darkness. There is a bookshelf to the east, and to the west of you.</value>
        </item>
        <item>
          <key>darkeast</key>
          <value>It is pitch black. You feel as if you have faded into the darkness. There is a bookshelf in front of you.</value>
        </item>
        <item>
          <key>darksouth</key>
          <value>It is pitch black. You feel as if you have faded into the darkness. There is a bookshelf to the east, and to the west of you. The path continues forwards.</value>
        </item>
        <item>
          <key>darkwest</key>
          <value>It is pitch black. You feel as if you have faded into the darkness. There is a bookshelf in front of you.</value>
        </item>
        <item>
          <key>dimnorth</key>
          <value>There is a bookshelf to the east, and to the west of you. The path continues forwards.</value>
        </item>
        <item>
          <key>dimeast</key>
          <value>There is a bookshelf in front of you. The path continues to the south, and to the north of you.</value>
        </item>
        <item>
          <key>dimsouth</key>
          <value>There is a bookshelf to the east, and to the west of you. The path continues forwards.</value>
        </item>
        <item>
          <key>dimwest</key>
          <value>There is a bookshelf in front of you. The path continues to the south, and to the north.</value>
        </item>
        <item>
          <key>brightnorth</key>
          <value>The light is so bright it makes your eyes burn, as if you were staring into the sun. It is so bright you cant see anything.</value>
        </item>
        <item>
          <key>brighteast</key>
          <value>The light is so bright it makes your eyes burn, as if you were staring into the sun. It is so bright you cant see anything.</value>
        </item>
        <item>
          <key>brightsouth</key>
          <value>The light is so bright it makes your eyes burn, as if you were staring into the sun. It is so bright you cant see anything.</value>
        </item>
        <item>
          <key>brightwest</key>
          <value>The light is so bright it makes your eyes burn, as if you were staring into the sun. It is so bright you cant see anything.</value>
        </item>
      </descriptions>
      <description type="script">
        PrintRoomDesc (False)
      </description>
      <exit name="South237" alias="south" to="defaultroom">
        <inherit name="southdirection" />
        <runscript />
        <script type="script">
          MoveAndFace (library101, 2)
        </script>
      </exit>
      <exit name="North236" alias="north" to="defaultroom">
        <inherit name="northdirection" />
        <runscript />
        <script type="script">
          MoveAndFace (library103, 0)
        </script>
      </exit>
    </object>
    <object name="library103">
      <inherit name="editor_room" />
      <usedefaultprefix />
      <descriptions type="stringdictionary">
        <item>
          <key>darknorth</key>
          <value>It is pitch black. You feel as if you have faded into the darkness. You are at a fork in the path. </value>
        </item>
        <item>
          <key>darkeast</key>
          <value>It is pitch black. You feel as if you have faded into the darkness. You are at a fork in the path.</value>
        </item>
        <item>
          <key>darksouth</key>
          <value>It is pitch black.  You feel as if you have faded into the darkness. You are at a fork in the path.</value>
        </item>
        <item>
          <key>darkwest</key>
          <value>It is pitch black. You feel as if you have faded into the darkness. You are at a fork in the path.</value>
        </item>
        <item>
          <key>dimnorth</key>
          <value>You are at a fork in the path. The path continues forwards, to the west, and to the east.</value>
        </item>
        <item>
          <key>dimeast</key>
          <value>You are at a fork in the path. The path continues forwards, to the south, and to the north.</value>
        </item>
        <item>
          <key>dimsouth</key>
          <value>You are at a fork in the path. The path continues forwards, to the west, and to the east.</value>
        </item>
        <item>
          <key>dimwest</key>
          <value>You are at a fork in the path. The path continues forwards, to the south, and to the west.</value>
        </item>
        <item>
          <key>brightnorth</key>
          <value>The light is so bright it makes your eyes burn, as if you were staring into the sun. It is so bright you cant see anything.</value>
        </item>
        <item>
          <key>brighteast</key>
          <value>The light is so bright it makes your eyes burn, as if you were staring into the sun. It is so bright you cant see anything.</value>
        </item>
        <item>
          <key>brightsouth</key>
          <value>The light is so bright it makes your eyes burn, as if you were staring into the sun. It is so bright you cant see anything.</value>
        </item>
        <item>
          <key>brightwest</key>
          <value>The light is so bright it makes your eyes burn, as if you were staring into the sun. It is so bright you cant see anything.</value>
        </item>
      </descriptions>
      <description type="script">
        PrintRoomDesc (False)
      </description>
      <exit name="West224" alias="west" to="defaultroom">
        <inherit name="westdirection" />
        <runscript />
        <visible />
        <script type="script">
          MoveAndFace (library98, 3)
        </script>
      </exit>
      <exit name="South238" alias="south" to="defaultroom">
        <inherit name="southdirection" />
        <runscript />
        <script type="script">
          MoveAndFace (library102, 2)
        </script>
      </exit>
      <exit name="East225" alias="east" to="defaultroom">
        <inherit name="eastdirection" />
        <runscript />
        <script type="script">
          MoveAndFace (library105, 1)
        </script>
      </exit>
      <exit name="North237" alias="north" to="defaultroom">
        <inherit name="northdirection" />
        <runscript />
        <script type="script">
          MoveAndFace (library104, 0)
        </script>
      </exit>
    </object>
    <object name="library104">
      <inherit name="editor_room" />
      <usedefaultprefix />
      <descriptions type="stringdictionary">
        <item>
          <key>darknorth</key>
          <value>It is pitch black. You feel as if you have faded into the darkness. There is a bookshelf in front of you, and to the east of you.</value>
        </item>
        <item>
          <key>darkeast</key>
          <value>It is pitch black. You feel as if you have faded into the darkness. There is a bookshelf in front of you, and to the north of you.</value>
        </item>
        <item>
          <key>darksouth</key>
          <value>It is pitch black. You feel as if you have faded into the darkness. There is a bookshelf to the east.</value>
        </item>
        <item>
          <key>darkwest</key>
          <value>It is pitch black. You feel as if you have faded into the darkness. The ground in front of you looks unstable, and there is a bookshelf to the north.</value>
        </item>
        <item>
          <key>dimnorth</key>
          <value>There is a bookshelf in front of you, and to the east of you. The ground to the north of you looks unstable. This is a dead end.</value>
        </item>
        <item>
          <key>dimeast</key>
          <value>There is a bookshelf in front of you, and to the north of you. This is a dead end, the path continues to the south. </value>
        </item>
        <item>
          <key>dimsouth</key>
          <value>There is a bookshelf to the east, and the ground to the west looks unstable. The path continues forwards.</value>
        </item>
        <item>
          <key>dimwest</key>
          <value>The ground in front of you looks unstable, and there is a bookshelf to the north. This is a dead end. The path continues to the south.</value>
        </item>
        <item>
          <key>brightnorth</key>
          <value>The light is so bright it makes your eyes burn, as if you were staring into the sun. It is so bright you cant see anything.</value>
        </item>
        <item>
          <key>brighteast</key>
          <value>The light is so bright it makes your eyes burn, as if you were staring into the sun. It is so bright you cant see anything.</value>
        </item>
        <item>
          <key>brightsouth</key>
          <value>The light is so bright it makes your eyes burn, as if you were staring into the sun. It is so bright you cant see anything.</value>
        </item>
        <item>
          <key>brightwest</key>
          <value>The light is so bright it makes your eyes burn, as if you were staring into the sun. It is so bright you cant see anything.</value>
        </item>
      </descriptions>
      <description type="script">
        PrintRoomDesc (False)
      </description>
      <exit name="West225" alias="west" to="defaultroom">
        <inherit name="westdirection" />
        <runscript />
        <visible />
        <script type="script">
          msg ("Your foot gets caught in a hole in the ground, where the floor seems to have rotted away. You fall to the ground, and your lantern falls from your grasp. You lantern gets snuffed from the commotion, and leaks some oil onto the ground.")
          msg ("You hear a screech in the distance. You get your foot unstuck, and go retrieve your lantern.")
          lantern.light_level = 0
          lantern.fuel_level = lantern.fuel_level - 10
          FaceEast
          player.parent = library95
        </script>
      </exit>
      <exit name="South239" alias="south" to="defaultroom">
        <inherit name="southdirection" />
        <runscript />
        <script type="script">
          MoveAndFace (library103, 2)
        </script>
      </exit>
    </object>
    <object name="library105">
      <inherit name="editor_room" />
      <usedefaultprefix />
      <descriptions type="stringdictionary">
        <item>
          <key>darknorth</key>
          <value>It is pitch black. You feel as if you have faded into the darkness. There is a bookshelf in front of you.</value>
        </item>
        <item>
          <key>darkeast</key>
          <value>It is pitch black. You feel as if you have faded into the darkness. There is a bookshelf to the north of you, and to the south of you.</value>
        </item>
        <item>
          <key>darksouth</key>
          <value>It is pitch black. You feel as if you have faded into the darkness. There is a bookshelf in front of you.</value>
        </item>
        <item>
          <key>darkwest</key>
          <value>It is pitch black. You feel as if you have faded into the darkness. There is a bookshelf to the south, and to the north of you.</value>
        </item>
        <item>
          <key>dimnorth</key>
          <value>There is a bookshelf in front of you. The path continues to the east, and to the west.</value>
        </item>
        <item>
          <key>dimeast</key>
          <value>There is a bookshelf to the north, and to the south of you. The path continues forwards.</value>
        </item>
        <item>
          <key>dimsouth</key>
          <value>There is a bookshelf in front of you. The path continues to the east, and to the west.</value>
        </item>
        <item>
          <key>dimwest</key>
          <value>There is a bookshelf to the south, and to the north of you.</value>
        </item>
        <item>
          <key>brightnorth</key>
          <value>The light is so bright it makes your eyes burn, as if you were staring into the sun. It is so bright you cant see anything.</value>
        </item>
        <item>
          <key>brighteast</key>
          <value>The light is so bright it makes your eyes burn, as if you were staring into the sun. It is so bright you cant see anything.</value>
        </item>
        <item>
          <key>brightsouth</key>
          <value>The light is so bright it makes your eyes burn, as if you were staring into the sun. It is so bright you cant see anything.</value>
        </item>
        <item>
          <key>brightwest</key>
          <value>The light is so bright it makes your eyes burn, as if you were staring into the sun. It is so bright you cant see anything.</value>
        </item>
      </descriptions>
      <description type="script">
        if (lantern.light_level = 0) {
          msg ("You stumble on something in the darkness and fall to the ground. You scramble onto all fours and frantically search for your lantern. Before you can find it, you remember that something was following you... but now the room is oddly silent.")
          msg ("You stand up, squinting to see. Nothing seems to be around. Suddenly, you feel breath down your neck. It is too late to run.")
          Die
        }
        else {
          PrintRoomDesc (False)
        }
      </description>
      <exit name="West226" alias="west" to="defaultroom">
        <inherit name="westdirection" />
        <runscript />
        <visible />
        <script type="script">
          MoveAndFace (library103, 3)
        </script>
      </exit>
      <exit name="East227" alias="east" to="defaultroom">
        <inherit name="eastdirection" />
        <runscript />
        <script type="script">
          MoveAndFace (library106, 1)
        </script>
      </exit>
    </object>
    <object name="library106">
      <inherit name="editor_room" />
      <usedefaultprefix />
      <descriptions type="stringdictionary">
        <item>
          <key>darknorth</key>
          <value>There is a bookshelf in front of you, it is beginning to catch on fire. The light from the flames burn your eyes. The ground to the west of you is covered in oil that is roaring in a hot flame.</value>
        </item>
        <item>
          <key>darkeast</key>
          <value>There is a bookshelf to the south of you, and to the north. They are beginning to go up in flames. The light from the fire is burning your eyes. </value>
        </item>
        <item>
          <key>darksouth</key>
          <value>There is a bookshelf in front of you, it is beginning to catch on fire. The light from the flames burn your eyes. The ground to the west of you is covered in oil that is roaring in a hot flame.</value>
        </item>
        <item>
          <key>darkwest</key>
          <value>There is a bookshelf to the south of you, and to the north. They are beginning to go up in flames. The light from the fire is burning your eyes. </value>
        </item>
        <item>
          <key>dimnorth</key>
          <value>N/A</value>
        </item>
        <item>
          <key>dimeast</key>
          <value>N/A</value>
        </item>
        <item>
          <key>dimsouth</key>
          <value>N/A</value>
        </item>
        <item>
          <key>dimwest</key>
          <value>N/A</value>
        </item>
        <item>
          <key>brightnorth</key>
          <value>N/A</value>
        </item>
        <item>
          <key>brighteast</key>
          <value>N/A</value>
        </item>
        <item>
          <key>brightsouth</key>
          <value>N/A</value>
        </item>
        <item>
          <key>brightwest</key>
          <value>N/A</value>
        </item>
      </descriptions>
      <description type="script">
        PrintRoomDesc (False)
      </description>
      <beforefirstenter type="script">
        msg ("The light is becoming too bright for you now, your eyes are watering and the lantern feels hot. Hotter than you remembered it ever feeling. You are disoriented by the brightness, and it feels like it is burning your hand. It stings, and you drop the lantern, unable to hold onto it any longer.")
        msg ("The lantern falls to the floor and smashes into bits, the oil leaks everywhere and ignites. The books start to catch fire -- everything starts to catch fire.")
        msg ("Your only choice is to continue down the hall, the rest of the area is bursting into flames quickly, and the light burns your eyes as if you were staring into the sun.")
        JumpScare
        lantern.parent = null
        lantern.light_level = 0
        library_turn_script.enabled = false
        fire_turn_script.enabled = true
        game.saveTime = True
        DisableHeart
      </beforefirstenter>
      <exit name="West227" alias="west" to="defaultroom">
        <inherit name="westdirection" />
        <runscript />
        <visible />
        <script type="script">
          MoveAndFace (library105, 3)
        </script>
      </exit>
      <exit name="East228" alias="east" to="defaultroom">
        <inherit name="eastdirection" />
        <runscript />
        <script type="script">
          MoveAndFace (library107, 1)
        </script>
      </exit>
    </object>
    <object name="library107">
      <inherit name="editor_room" />
      <usedefaultprefix />
      <descriptions type="stringdictionary">
        <item>
          <key>darknorth</key>
          <value>There is a bookshelf in front of you, it is going up in flames. The light from the fire is burning your eyes.</value>
        </item>
        <item>
          <key>darkeast</key>
          <value>There is a bookshelf to the south of you, and to the north. They are beginning to go up in flames. The light from the fire is burning your eyes. </value>
        </item>
        <item>
          <key>darksouth</key>
          <value>There is a bookshelf in front of you, it is going up in flames. The light from the fire is burning your eyes.</value>
        </item>
        <item>
          <key>darkwest</key>
          <value>There is a bookshelf to the south of you, and to the north. They are beginning to go up in flames. The light from the fire is burning your eyes. </value>
        </item>
        <item>
          <key>dimnorth</key>
          <value>N/A</value>
        </item>
        <item>
          <key>dimeast</key>
          <value>N/A</value>
        </item>
        <item>
          <key>dimsouth</key>
          <value>N/A</value>
        </item>
        <item>
          <key>dimwest</key>
          <value>N/A</value>
        </item>
        <item>
          <key>brightnorth</key>
          <value>N/A</value>
        </item>
        <item>
          <key>brighteast</key>
          <value>N/A</value>
        </item>
        <item>
          <key>brightsouth</key>
          <value>N/A</value>
        </item>
        <item>
          <key>brightwest</key>
          <value>N/A</value>
        </item>
      </descriptions>
      <description type="script">
        PrintRoomDesc (False)
      </description>
      <exit name="West228" alias="west" to="defaultroom">
        <inherit name="westdirection" />
        <runscript />
        <visible />
        <script type="script">
          MoveAndFace (library106, 3)
        </script>
      </exit>
      <exit name="East229" alias="east" to="defaultroom">
        <inherit name="eastdirection" />
        <runscript />
        <script type="script">
          MoveAndFace (library108, 1)
        </script>
      </exit>
    </object>
    <object name="library108">
      <inherit name="editor_room" />
      <usedefaultprefix />
      <descriptions type="stringdictionary">
        <item>
          <key>darknorth</key>
          <value>There is a bookshelf in front of you, it is going up in flames. The light from the fire is burning your eyes.</value>
        </item>
        <item>
          <key>darkeast</key>
          <value>There is a bookshelf to the south of you, and to the north. They are beginning to go up in flames. The light from the fire is burning your eyes. </value>
        </item>
        <item>
          <key>darksouth</key>
          <value>There is a bookshelf in front of you, it is going up in flames. The light from the fire is burning your eyes.</value>
        </item>
        <item>
          <key>darkwest</key>
          <value>There is a bookshelf to the south of you, and to the north. They are beginning to go up in flames. The light from the fire is burning your eyes. </value>
        </item>
        <item>
          <key>dimnorth</key>
          <value>N/A</value>
        </item>
        <item>
          <key>dimeast</key>
          <value>N/A</value>
        </item>
        <item>
          <key>dimsouth</key>
          <value>N/A</value>
        </item>
        <item>
          <key>dimwest</key>
          <value>N/A</value>
        </item>
        <item>
          <key>brightnorth</key>
          <value>N/A</value>
        </item>
        <item>
          <key>brighteast</key>
          <value>N/A</value>
        </item>
        <item>
          <key>brightsouth</key>
          <value>N/A</value>
        </item>
        <item>
          <key>brightwest</key>
          <value>N/A</value>
        </item>
      </descriptions>
      <description type="script">
        PrintRoomDesc (False)
      </description>
      <exit name="West229" alias="west" to="defaultroom">
        <inherit name="westdirection" />
        <runscript />
        <visible />
        <script type="script">
          MoveAndFace (library107, 3)
        </script>
      </exit>
      <exit name="East230" alias="east" to="defaultroom">
        <inherit name="eastdirection" />
        <runscript />
        <script type="script">
          MoveAndFace (library109, 1)
        </script>
      </exit>
    </object>
    <object name="library109">
      <inherit name="editor_room" />
      <usedefaultprefix />
      <descriptions type="stringdictionary">
        <item>
          <key>darknorth</key>
          <value>There is a bookshelf in front of you, it is going up in flames. The light from the fire is burning your eyes.</value>
        </item>
        <item>
          <key>darkeast</key>
          <value>There is a bookshelf to the south of you, and to the north. They are beginning to go up in flames. The light from the fire is burning your eyes. </value>
        </item>
        <item>
          <key>darksouth</key>
          <value>There is a bookshelf in front of you, it is going up in flames. The light from the fire is burning your eyes.</value>
        </item>
        <item>
          <key>darkwest</key>
          <value>There is a bookshelf to the south of you, and to the north. They are beginning to go up in flames. The light from the fire is burning your eyes. </value>
        </item>
        <item>
          <key>dimnorth</key>
          <value>N/A</value>
        </item>
        <item>
          <key>dimeast</key>
          <value>N/A</value>
        </item>
        <item>
          <key>dimsouth</key>
          <value>N/A</value>
        </item>
        <item>
          <key>dimwest</key>
          <value>N/A</value>
        </item>
        <item>
          <key>brightnorth</key>
          <value>N/A</value>
        </item>
        <item>
          <key>brighteast</key>
          <value>N/A</value>
        </item>
        <item>
          <key>brightsouth</key>
          <value>N/A</value>
        </item>
        <item>
          <key>brightwest</key>
          <value>N/A</value>
        </item>
      </descriptions>
      <description type="script">
        PrintRoomDesc (False)
      </description>
      <exit name="West230" alias="west" to="defaultroom">
        <inherit name="westdirection" />
        <runscript />
        <visible />
        <script type="script">
          MoveAndFace (library108, 3)
        </script>
      </exit>
      <exit name="East231" alias="east" to="defaultroom">
        <inherit name="eastdirection" />
        <runscript />
        <script type="script">
          MoveAndFace (library110, 1)
        </script>
      </exit>
    </object>
    <object name="library110">
      <inherit name="editor_room" />
      <usedefaultprefix />
      <descriptions type="stringdictionary">
        <item>
          <key>darknorth</key>
          <value>There is a bookshelf in front of you, it is going up in flames. The light from the fire is burning your eyes.</value>
        </item>
        <item>
          <key>darkeast</key>
          <value>There is a bookshelf to the south of you, and to the north. They are beginning to go up in flames. The light from the fire is burning your eyes. </value>
        </item>
        <item>
          <key>darksouth</key>
          <value>There is a bookshelf in front of you, it is going up in flames. The light from the fire is burning your eyes.</value>
        </item>
        <item>
          <key>darkwest</key>
          <value>There is a bookshelf to the south of you, and to the north. They are beginning to go up in flames. The light from the fire is burning your eyes. </value>
        </item>
        <item>
          <key>dimnorth</key>
          <value>N/A</value>
        </item>
        <item>
          <key>dimeast</key>
          <value>N/A</value>
        </item>
        <item>
          <key>dimsouth</key>
          <value>N/A</value>
        </item>
        <item>
          <key>dimwest</key>
          <value>N/A</value>
        </item>
        <item>
          <key>brightnorth</key>
          <value>N/A</value>
        </item>
        <item>
          <key>brighteast</key>
          <value>N/A</value>
        </item>
        <item>
          <key>brightsouth</key>
          <value>N/A</value>
        </item>
        <item>
          <key>brightwest</key>
          <value>N/A</value>
        </item>
      </descriptions>
      <description type="script">
        PrintRoomDesc (False)
      </description>
      <exit name="West231" alias="west" to="defaultroom">
        <inherit name="westdirection" />
        <runscript />
        <visible />
        <script type="script">
          MoveAndFace (library109, 3)
        </script>
      </exit>
      <exit name="East232" alias="east" to="defaultroom">
        <inherit name="eastdirection" />
        <runscript />
        <script type="script">
          MoveAndFace (library111, 1)
        </script>
      </exit>
    </object>
    <object name="library111">
      <inherit name="editor_room" />
      <usedefaultprefix />
      <descriptions type="stringdictionary">
        <item>
          <key>darknorth</key>
          <value>There is a bookshelf in front of you, it is going up in flames. The light from the fire is burning your eyes. There is a door to the east of you.</value>
        </item>
        <item>
          <key>darkeast</key>
          <value>There is a bookshelf to the south of you, and to the north. They are beginning to go up in flames. The light from the fire is burning your eyes. There is a door in front of you.</value>
        </item>
        <item>
          <key>darksouth</key>
          <value>There is a bookshelf in front of you, it is going up in flames. The light from the fire is burning your eyes. There is a door to the east of you.</value>
        </item>
        <item>
          <key>darkwest</key>
          <value>There is a bookshelf to the south of you, and to the north. They are beginning to go up in flames. The light from the fire is burning your eyes. </value>
        </item>
        <item>
          <key>dimnorth</key>
          <value>N/A</value>
        </item>
        <item>
          <key>dimeast</key>
          <value>N/A</value>
        </item>
        <item>
          <key>dimsouth</key>
          <value>N/A</value>
        </item>
        <item>
          <key>dimwest</key>
          <value>N/A</value>
        </item>
        <item>
          <key>brightnorth</key>
          <value>N/A</value>
        </item>
        <item>
          <key>brighteast</key>
          <value>N/A</value>
        </item>
        <item>
          <key>brightsouth</key>
          <value>N/A</value>
        </item>
        <item>
          <key>brightwest</key>
          <value>N/A</value>
        </item>
      </descriptions>
      <description type="script">
        PrintRoomDesc (False)
      </description>
      <exit name="West232" alias="west" to="defaultroom">
        <inherit name="westdirection" />
        <runscript />
        <visible />
        <script type="script">
          MoveAndFace (library110, 3)
        </script>
      </exit>
      <exit name="LibraryExit" alias="east" to="hub7">
        <inherit name="eastdirection" />
        <runscript />
        <script type="script">
          EndLibrary
        </script>
      </exit>
      <object name="door">
        <inherit name="editor_object" />
        <inherit name="openable" />
        <feature_container />
        <close type="boolean">false</close>
        <open type="boolean">false</open>
        <openscript type="script">
          EndLibrary
        </openscript>
      </object>
    </object>
  </object>
  <turnscript name="butcher_turn_script">
    <enabled />
    <script><![CDATA[
      if (kitchen.inside) {
        if (player.parent.bloodTrail and Got(lantern) and not lantern.light_level = 0) {
          kitchen.butcherTimer = 0
          x = GetRandomInt(1,10)
          if (x <= 2 and lantern.light_level < 2) {
            flavour = GetRandomInt(1,3)
            switch (flavour) {
              case (0) {
                msg ("You hear footsteps in the distance. You cannot tell if they are getting closer...")
              }
              case (1) {
                msg ("You hear chopping and grunting. The sound echoes around you, and you cannot tell where they are coming from.")
              }
              case (2) {
                msg ("You feel something on the back of your neck. It feels like someones breath but you cant tell...")
              }
            }
          }
        }
        else {
          switch (kitchen.butcherTimer) {
            case (0) {
              msg ("The room has become very silent.")
            }
            case (2) {
              msg ("You feel like you are being watched.")
            }
            case (3) {
              msg ("You hear heavy footsteps moving toward you.")
            }
            case (4) {
              msg ("The footsteps are getting closer.")
            }
            case (5) {
              msg ("You hear something rushing at you. The pungent odor of rotting meat fills your lungs, and you cough, closing your eyes. You feel a brush wind across your face, and hear movement in front of you. You open your eyes to see the glint of a butchers knife swing down.")
              Die
            }
          }
          kitchen.butcherTimer = kitchen.butcherTimer + 1
        }
      }
    ]]></script>
  </turnscript>
  <turnscript name="peter_turn_script">
    <script><![CDATA[
      Peter.distance = Peter.distance - 1
      if (game.debug) {
        msg ("DEBUG: PETER DISTANCE = " + Peter.distance)
      }
      if (nursery46.door_closed) {
        if (player.parent <> nursery47) {
          ResetPeter
        }
        else {
          msg ("You see the small boy claw out from under the hanging coats, and other garments. His face is screwed up with rage, and he looks deranged. Half of his face looks as if it was melted off in a fire, and he spits, and growls at you. He clears the coats, and dives at you, knocking you down. Ripping at your flesh with his claws, he tears chunks of skin off your limbs. You try to push him off, but your hands go right through him. The only part of him that seems to be able to affect you are his hands, and you reach out to grab them to throw him off, but he is faster. He glares straight into your eyes, while reaching out and clawing at your throat. You feel yourself choke on your blood as he snarls, and stands over you as you bleed out on the ground.")
          Die
        }
      }
      else if (Peter.distance <= 0) {
        msg ("You see the small boy claw out from under the hanging coats, and other garments. His face is screwed up rage, and he looks deranged. Half of his face looks as if it was melted off in a fire, and he spits, and growls at you. He clears the coats, and dives at you knocking you down. Ripping at your flesh with his claws, he tears chunks of skin off your limbs. You try to push him off, but your hands go right through him. The only part of him that seems to be able to affect you are his hands, and you reach out to grab them to throw him off, but he is faster. He glares straight into your eyes, while reaching out and clawing at your throat. You feel yourself choke on your blood as he snarls, and stands over you as you bleed out on the ground. ")
        Die
      }
    ]]></script>
  </turnscript>
  <verb>
    <property>fix</property>
    <pattern>fix</pattern>
    <defaultexpression>"You can't fix " + object.article + "."</defaultexpression>
  </verb>
  <turnscript name="item_follow_script">
    <enabled />
    <script><![CDATA[
      // This is kind of horrible, but makes the oil accessible from multiple places
      if (oil2.parent <> null) {
        if (player.parent = kitchen68 or player.parent = kitchen75 or player.parent = kitchen69) {
          oil2.parent = player.parent
        }
      }
      if (oil4.parent <> null) {
        if (player.parent = nursery29 or player.parent = nursery30 or player.parent = nursery37 or player.parent = nursery42 or player.parent = nursery43) {
          oil4.parent = player.parent
        }
      }
      if (oil5.parent <> null) {
        if (player.parent = nursery32 or player.parent = nursery33 or player.parent = nursery39) {
          oil5.parent = player.parent
        }
      }
      if (oil6.parent <> null) {
        if (player.parent = nursery57 or player.parent = nursery58 or player.parent = nursery63 or player.parent = nursery65 or player.parent = nursery66) {
          oil6.parent = player.parent
        }
      }
      if (player.parent = kitchen63 or player.parent = kitchen66 or player.parent = kitchen67 or player.parent = kitchen70) {
        turkey.parent = player.parent
      }
      if (player.parent = hub12 or player.parent = hub13 or player.parent = hub8 or player.parent = hub16) {
        chessboard.parent = player.parent
      }
    ]]></script>
  </turnscript>
  <verb>
    <property>rattle</property>
    <pattern>rattle</pattern>
    <defaultexpression>"You can't rattle " + object.article + "."</defaultexpression>
  </verb>
  <verb>
    <property>smack</property>
    <pattern>smack</pattern>
    <defaultexpression>"You can't smack " + object.article + "."</defaultexpression>
  </verb>
  <verb>
    <property>knockdown</property>
    <pattern>knock down</pattern>
    <defaultexpression>"You can't knock down " + object.article + "."</defaultexpression>
  </verb>
  <verb>
    <property>knockover</property>
    <pattern>knock over</pattern>
    <defaultexpression>"You can't knock over " + object.article + "."</defaultexpression>
  </verb>
  <turnscript name="grumpy_shadow_turn_script">
    <enabled />
    <script><![CDATA[
      if (player.parent = library41 or player.parent = library42 or player.parent = library43 or player.parent = library44 or player.parent = library49 or player.parent = library51 or player.parent = library52 or player.parent = library52 or player.parent = library57 or player.parent = library59 or player.parent = library65 or player.parent = library66 or player.parent = library67 or player.parent = library68) {
        if (lantern.light_level > 0) {
          library.grumpy_shadow_counter = library.grumpy_shadow_counter + 1
        }
        else {
          library.grumpy_shadow_counter = 0
        }
        if (library.grumpy_shadow_counter = 4) {
          msg ("The creature charges at you, snarling. He knocks you over while trying to punch your lantern. You fall to the ground, on your back. The lantern crashes on top of you, exploding like a fiery bomb, the glass splintering, and flying like shrapnel. You feel yourself cut up, and burning from the fire, but it wasnt powerful enough to knock you unconscious, or kill you.")
          msg ("The flames roar brightly, this enrages the creature even more, and he snarls, and begins stomping on the fire to put it out. Then, you realize that you are on fire... You feel a crushing blow to your ribs, and all the air is knocked out of you. You see him raise his foot again.")
          Die
        }
      }
      else {
        library.grumpy_shadow_counter = 0
      }
    ]]></script>
  </turnscript>
  <verb>
    <property>dim</property>
    <pattern>dim</pattern>
    <defaultexpression>"You can't dim " + object.article + "."</defaultexpression>
  </verb>
  <turnscript name="library_turn_script">
    <script><![CDATA[
      x = GetRandomInt(1,10)
      if (x <= 2 and lantern.light_level < 2) {
        flavour = GetRandomInt(1,3)
        switch (flavour) {
          case (0) {
            msg ("You feel a gust of wind blow past you, you cannot see anything that caused it.")
          }
          case (1) {
            msg ("You feel like something is watching you from atop the bookshelves.")
          }
          case (2) {
            msg ("You hear something coming from the shadows, but you cannot see anything...")
          }
        }
      }
      if (not lantern.light_level = 0) {
        library.darknessTimer = 0
      }
      else {
        switch (library.darknessTimer) {
          case (2) {
            msg ("You feel as if something is watching you.")
          }
          case (4) {
            msg ("You hear the shuffling of feet, but you aren't sure where it's coming from.")
          }
          case (6) {
            msg ("The shuffling is getting louder.")
          }
          case (7) {
            msg ("Something nearby is breathing heavily.")
          }
          case (9) {
            msg ("Whatever was following you has become extremely silent.")
          }
          case (10) {
            msg ("You feel something breathing down the back of your neck. You try to run, and fumble for your lantern hoping you have enough oil to scare the creature off.")
            msg ("Before you can, it knocks the lantern from your hands, and growls at you. It stares you down, all you can see is the glow of its eyes. There are no words to describe its appearance except that it is shrouded in the shadows. It lunges at you.")
            Die
          }
        }
        library.darknessTimer = library.darknessTimer + 1
      }
    ]]></script>
  </turnscript>
  <turnscript name="laila_turn_script">
    <enabled type="boolean">false</enabled>
    <script><![CDATA[
      if (not Laila.paused) {
        if (Laila.chase_state = 0 and GetRandomDouble() < .125) {
          msg ("You hear distant giggling...")
          Laila.chase_state = 1
          switch (player.facing_num) {
            case (0) {
              Laila.attack_from = 2
            }
            case (2) {
              Laila.attack_from = 0
            }
            case (1) {
              if (GetRandomDouble() < .5) {
                Laila.attack_from = 2
              }
              else {
                Laila.attack_from = 0
              }
            }
            case (3) {
              if (GetRandomDouble() < .5) {
                Laila.attack_from = 2
              }
              else {
                Laila.attack_from = 0
              }
            }
          }
          if (game.debug) {
            msg ("DEBUG: Laila advancing to stage 1: attacking from " + Laila.attack_from)
          }
        }
        else if (Laila.chase_state = 1) {
          // Don't advance if you're bright or looking at her
          if (lantern.light_level <> 2 or (lantern.light_level = 2 and (not (player.facing_num = Laila.attack_from)))) {
            // Tick at least once
            // On second 50/50 chance to advance or stay in 2
            // On third tick always move to state 3 (PS, these comments used to be in useful places, but quest moves them to a shitty place)
            if (Laila.sub_state = 0) {
              Laila.sub_state = 1
            }
            else if (Laila.sub_state = 1) {
              if (GetRandomDouble() < .5) {
                Laila.sub_state = 0
                Laila.chase_state = 2
                if (game.debug) {
                  msg ("DEBUG: Laila advancing to stage 2 on 2")
                }
              }
              else {
                Laila.sub_state = 2
              }
            }
            else if (Laila.sub_state = 2) {
              Laila.sub_state = 0
              Laila.chase_state = 2
              if (game.debug) {
                msg ("DEBUG: Laila advancing to stage 2 on 3")
              }
            }
          }
          else if (game.debug) {
            msg ("DEBUG: Laila waiting in stage 1")
          }
        }
        else if (Laila.chase_state = 2) {
          // Don't advance if you're bright or looking at her
          if ((lantern.light_level = 0) or ( (not (player.facing_num = Laila.attack_from)) and (lantern.light_level <> 0)) ) {
            // Tick at least once
            // On second 50/50 chance to advance or stay in 2
            // On third tick always move to state 3 (PS, these comments used to be in useful places, but quest moves them to a shitty place)
            if (Laila.sub_state = 0) {
              Laila.sub_state = 1
            }
            else if (Laila.sub_state = 1) {
              if (GetRandomDouble() < .5) {
                Laila.sub_state = 0
                Laila.chase_state = 3
                if (game.debug) {
                  msg ("DEBUG: Laila advancing to stage 3 on 2")
                }
              }
              else {
                Laila.sub_state = 2
              }
            }
            else if (Laila.sub_state = 2) {
              Laila.sub_state = 0
              Laila.chase_state = 3
              if (game.debug) {
                msg ("DEBUG: Laila advancing to stage 3 on 3")
              }
            }
          }
          else if (game.debug) {
            msg ("DEBUG: Laila waiting in stage 2")
          }
        }
        else if (Laila.chase_state = 3) {
          // Don't advance if you're bright or looking at her
          if ((lantern.light_level = 0) or (not (player.facing_num = Laila.attack_from))) {
            // Tick at least once
            // On second 50/50 chance to advance or stay in 3
            // On third tick always move to state 4 (PS, these comments used to be in useful places, but quest moves them to a shitty place)
            if (Laila.sub_state = 0) {
              Laila.sub_state = 1
            }
            else if (Laila.sub_state = 1) {
              if (GetRandomDouble() < .5) {
                Laila.sub_state = 0
                Laila.chase_state = 4
              }
              else {
                Laila.sub_state = 2
                if (game.debug) {
                  msg ("DEBUG: Laila advancing to stage 4 on 2")
                }
              }
            }
            else if (Laila.sub_state = 2) {
              Laila.sub_state = 0
              Laila.chase_state = 4
              if (game.debug) {
                msg ("DEBUG: Laila advancing to stage 4 on 3")
              }
            }
          }
          else if (game.debug) {
            msg ("DEBUG: Laila waiting in stage 3")
          }
        }
        else if (Laila.chase_state = 4) {
          if (lantern.light_level <> 0) {
            OutputTextNoBr ("You fumble and manage to turn up you lantern too late. ")
          }
          msg ("'Lets play' she giggles, and tackles you to the ground. You wheeze, having the air knocked out of you. You feel like you were hit with a ton of bricks, and your limbs feel too heavy to move. You dont know how a little girl could be so powerful. 'Why wont you play with me' she screams, her face screwing up in malice. She begins to slam your head on the hard stone floor, disorienting you so there is no hope of fighting back. 'Why' slam 'wont' slam 'you' slam 'PLAY WITH ME!' she slams your head on the ground again, with more ferocity this time.")
          Die
        }
      }
      if (not Laila.paused) {
        // Now print descriptions
        if (player.facing_num = Laila.attack_from) {
          if (lantern.light_level = 2 and Laila.chase_state = 1) {
            msg ("You see a faint glimmering in the distance.")
          }
          else if (Laila.chase_state = 2) {
            if (lantern.light_level = 1) {
              msg ("You see a faint glimmering a few meters away from you.")
            }
            else if (lantern.light_level = 2) {
              msg ("You see a ghostly figure a few meters away from you.")
            }
          }
          else if (Laila.chase_state = 3) {
            if (lantern.light_level = 2) {
              msg ("You hear a shriek from the girl, 'I just wanted to play!', as she fades from existence.")
              // Reset Laila
              Laila.sub_state = 0
              Laila.chase_state = 0
              if (game.debug) {
                msg ("Debug: Laila reset.")
              }
            }
            else if (lantern.light_level = 1) {
              msg ("A ghostly figure resembling a girl floats a short distance from you. You can see excitement on her face.")
            }
            else {
              msg ("There's a faint glowing resembling a child floating a few feet off the ground not far in front off you.")
            }
          }
        }
      }
    ]]></script>
  </turnscript>
  <command name="Remember">
    <pattern type="string">(remember|remember riddle|riddle)</pattern>
    <script>
      msg ("You try to recall the last riddle you received...")
      msg ("")
      PrintRiddle (game.part)
    </script>
  </command>
  <turnscript name="lantern_heart_turn_script">
    <enabled />
    <script><![CDATA[
      request (RunScript, "resetHeartCount")
      if (Got(lantern)) {
        if (lantern.fuel_level <= 0 and lantern.burnt_out <> True) {
          lantern.light_level = 0
          lantern.burnt_out = True
          msg ("Your lantern flame flickers for a moment and disappears. The room is engulfed in darkness.")
          lantern.fuel_level = lantern.fuel_level - lantern.light_level
        }
        else if (lantern.fuel_level - lantern.light_level < 10 and lantern.low_fuel <> True) {
          lantern.low_fuel = True
          if (lantern.light_level = 2) {
            lantern.light_level = 1
            msg ("Your lantern flame begins to gutter. You're forced to turn it down to maintain a steady flame. Your eyes adjust to the light level.")
          }
          else if (lantern.light_level = 1) {
            msg ("You notice that your lantern's reservoir is nearly fumes. Turning it up will probably be impossible until you get more fuel.")
          }
          lantern.fuel_level = lantern.fuel_level - lantern.light_level
        }
        else {
          lantern.fuel_level = lantern.fuel_level - lantern.light_level
        }
        if (game.debug) {
          msg ("FUEL DEBUG: " + lantern.fuel_level)
        }
      }
      if (game.heartRate < game.defaultHeartRate) {
        offset = game.defaultHeartRate - game.heartRate
        if (offset >= game.jumpScareAmount * 2 / 3) {
          msg ("Your heart is pounding and your breath is short.")
        }
        else if (offset >= game.jumpScareAmount * 1 / 3) {
          msg ("Your heart is beating quickly.")
        }
        else {
          msg ("Your heart is starting to calm down.")
        }
        newHeartRate = game.heartRate + 150
        if (newHeartRate <= game.defaultHeartRate) {
          SetHeartRate (newHeartRate)
        }
        else {
          SetHeartRate (game.defaultHeartRate)
        }
      }
      if (game.reenableCount < 1) {
        game.reenableCount = game.reenableCount + 1
      }
      else {
        EnableHeart
        game.helpShown = true
      }
      if (not game.heartEnabled and not game.gameover) {
        msg ("")
        msg ("(Time is paused. Enter any command to continue.)")
        if (not game.helpShown) {
          msg ("(Type HELP for gameplay help.)")
        }
      }
      if (game.saveTime) {
        msg ("<b>(Now is probably a good time to save!)</b>")
      }
    ]]></script>
  </turnscript>
  <turnscript name="fire_turn_script">
    <enabled type="boolean">false</enabled>
    <script><![CDATA[
      JumpScare
      if (library.fireCount > 10) {
        msg ("The bookshelves are engulfed in flames and the blaze surrounds you completely. The burning pain -- whether from the fire itself or merely from exposure to the blinding light -- is overwhelming. Smoke fills your lungs and you collapse to the floor. You desperately crawl toward the exit... but it is too late.")
        Die
      }
      else if (library.fireCount > 5) {
        msg ("You can feel your flesh burning.")
      }
      library.fireCount = library.fireCount + 1
    ]]></script>
  </turnscript>
  <turnscript name="nursery_turn_script">
    <script><![CDATA[
      x = GetRandomInt(1,10)
      if (x <= 2 and lantern.light_level < 2) {
        flavour = GetRandomInt(1,3)
        switch (flavour) {
          case (0) {
            msg ("You feel something brush past you, and look around, but you cant see anything")
          }
          case (1) {
            msg ("You think you see a doll in shadows in front of you. You blink, and its gone.")
          }
          case (2) {
            msg ("There is something moving in the shadows, and you cant quite make it out. You squint, and it stops. The stillness is eerie.")
          }
        }
      }
      if (not lantern.light_level = 0) {
        nursery.darknessTimer = 0
      }
      else {
        switch (nursery.darknessTimer) {
          case (2) {
            msg ("You feel as if something is watching you.")
          }
          case (4) {
            msg ("You hear the shuffling of feet, but you aren't sure where it's coming from.")
          }
          case (6) {
            msg ("The shuffling is getting louder.")
          }
          case (7) {
            msg ("Something nearby is breathing heavily.")
          }
          case (9) {
            msg ("Whatever was following you has become extremely silent.")
          }
          case (10) {
            msg ("You feel something breathing down the back of your neck. You try to run, and fumble for your lantern hoping you have enough oil to scare the creature off.")
            msg ("Before you can, it knocks the lantern from your hands, and growls at you. It stares you down, all you can see is the glow of its eyes. There are no words to describe its appearance except that it is shrouded in the shadows. It lunges at you.")
            Die
          }
        }
        nursery.darknessTimer = nursery.darknessTimer + 1
      }
    ]]></script>
  </turnscript>
  <turnscript name="geoffrey_turn_script">
    <enabled type="boolean">false</enabled>
    <script><![CDATA[
      if (player.parent <> player.lastPos) {
        if (game.heartCount = "4" or game.heartCount = "5" or game.heartCount = "6") {
          game.geoffreyCount = game.geoffreyCount - 1
          if (game.geoffreyCount < 0) {
            game.geoffreyCount = 0
          }
        }
        else {
          game.geoffreyCount = game.geoffreyCount + 1
        }
      }
      switch (game.geoffreyCount) {
        case (1) {
          msg ("You can hear a child grunting in the far end of the room as if he is agitated.")
        }
        case (2) {
          msg ("There is angry slamming coming from the far end of the room.")
        }
        case (3) {
          msg ("You hear a heavy sigh come from the small boy in the corner. He stands up, and looks irritated. He glares at you, and screams \"Shut up, shut up, shut up!\" He growls and starts charging at you, you take a step back and lose your balance, tripping on a stray toy. You tumble, face down, to the ground, and as you are trying to get back up you see his feet on the ground in front of you. You look up at him, and he is looking at you, coldly. \"I know how to make you shut up.\" He raises his fist, which is clenching a bone from the anatomy skeleton he was playing with before though, it looks like a real human bone, fashioned into a shiv. \"At least I will have another toy...\" he swings his arm down, and stabs the bone into your neck.")
          Die
        }
      }
      player.lastPos = player.parent
    ]]></script>
  </turnscript>
  <function name="RunTurnScripts">
    if (IsGameRunning()) {
      if (game.fakeTurn) {
        if (game.menucallback = null) {
          foreach (turnscript, AllTurnScripts()) {
            if (GetBoolean(turnscript, "enabled")) {
              inscope = false
              if (turnscript.parent = game or turnscript.parent = null) {
                inscope = true
              }
              else {
                if (Contains(turnscript.parent, game.pov)) {
                  inscope = true
                }
              }
              if (inscope) {
                do (turnscript, "script")
              }
            }
          }
        }
        game.fakeTurn = false
      }
      else {
        game.fakeTurn = true
      }
    }
  </function>
  <function name="PrintRoomDesc" parameters="all">
    if (Got(lantern)) {
      if (lantern.light_level = 0 or player.parent.parent = hub or player.parent.parent = dungeon) {
        switch (player.facing_num) {
          case (0) {
            msg (StringDictionaryItem (player.parent.descriptions, "darknorth"))
          }
          case (1) {
            msg (StringDictionaryItem (player.parent.descriptions, "darkeast"))
          }
          case (2) {
            msg (StringDictionaryItem (player.parent.descriptions, "darksouth"))
          }
          case (3) {
            msg (StringDictionaryItem (player.parent.descriptions, "darkwest"))
          }
        }
      }
      else if (lantern.light_level = 1) {
        switch (player.facing_num) {
          case (0) {
            msg (StringDictionaryItem (player.parent.descriptions, "dimnorth"))
          }
          case (1) {
            msg (StringDictionaryItem (player.parent.descriptions, "dimeast"))
          }
          case (2) {
            msg (StringDictionaryItem (player.parent.descriptions, "dimsouth"))
          }
          case (3) {
            msg (StringDictionaryItem (player.parent.descriptions, "dimwest"))
          }
        }
      }
      else if (lantern.light_level = 2) {
        switch (player.facing_num) {
          case (0) {
            msg (StringDictionaryItem (player.parent.descriptions, "brightnorth"))
          }
          case (1) {
            msg (StringDictionaryItem (player.parent.descriptions, "brighteast"))
          }
          case (2) {
            msg (StringDictionaryItem (player.parent.descriptions, "brightsouth"))
          }
          case (3) {
            msg (StringDictionaryItem (player.parent.descriptions, "brightwest"))
          }
        }
      }
    }
    else {
      switch (player.facing_num) {
        case (0) {
          msg (StringDictionaryItem (player.parent.descriptions, "darknorth"))
        }
        case (1) {
          msg (StringDictionaryItem (player.parent.descriptions, "darkeast"))
        }
        case (2) {
          msg (StringDictionaryItem (player.parent.descriptions, "darksouth"))
        }
        case (3) {
          msg (StringDictionaryItem (player.parent.descriptions, "darkwest"))
        }
      }
    }
  </function>
  <function name="FaceNorth">
    player.facing_num = 0
    dictionary remove (player.statusattributes, "facing")
    dictionary add (player.statusattributes, "facing", StringListItem(player.facings, player.facing_num))
  </function>
  <function name="FaceEast">
    player.facing_num = 1
    dictionary remove (player.statusattributes, "facing")
    dictionary add (player.statusattributes, "facing", StringListItem(player.facings, player.facing_num))
  </function>
  <function name="FaceSouth">
    player.facing_num = 2
    dictionary remove (player.statusattributes, "facing")
    dictionary add (player.statusattributes, "facing", StringListItem(player.facings, player.facing_num))
  </function>
  <function name="FaceWest">
    player.facing_num = 3
    dictionary remove (player.statusattributes, "facing")
    dictionary add (player.statusattributes, "facing", StringListItem(player.facings, player.facing_num))
  </function>
  <function name="MoveAndFace" parameters="Dest, Facing">
    switch (Facing) {
      case (0) {
        FaceNorth
      }
      case (1) {
        FaceEast
      }
      case (2) {
        FaceSouth
      }
      case (3) {
        FaceWest
      }
    }
    MoveObject (player, Dest)
  </function>
  <function name="TimeOut" parameters="all">
    msg ("")
    msg ("Time passes.")
  </function>
  <function name="SetHeartRate" parameters="heartRate">
    game.heartRate = heartRate
    request (RunScript, "setHeartRate; " + game.heartRate)
  </function>
  <function name="ResetPeter">
    Peter.distance = Peter.start_distance
    Peter.chasing = False
    DisableTurnScript (peter_turn_script)
    if (game.debug) {
      msg ("DEBUG: PETER NO LONGER CHASING")
    }
  </function>
  <function name="EnableHeart">
    request (RunScript, "enableHeart")
    game.heartEnabled = true
    game.saveTime = false
  </function>
  <function name="DisableHeart">
    request (RunScript, "disableHeart")
    game.heartEnabled = false
    game.reenableCount = 0
  </function>
  <function name="Die">
    msg ("")
    msg ("You have died.")
    FinishGame
  </function>
  <function name="GetJS" parameters="all">
    SetHeartRate (game.heartRate)
    if (game.heartEnabled) {
      EnableHeart
    }
    else {
      DisableHeart
    }
  </function>
  <function name="SetHeartCount" parameters="heartCount">
    game.heartCount = heartCount
    request (RunScript, "setHeartCount; " + game.heartCount)
  </function>
  <function name="UpdateHeartCount" parameters="heartCount">
    game.heartCount = heartCount
  </function>
  <function name="JumpScare">
    SetHeartRate (game.defaultHeartRate - game.jumpScareAmount)
  </function>
  <function name="AddFuel" parameters="amount" type="int"><![CDATA[
    lantern.fuel_level = lantern.fuel_level + amount
    if (lantern.fuel_level > 60) {
      lantern.fuel_level = 80
    }
  ]]></function>
  <function name="GetOil" parameters="oilObject" type="object">
    if (Got(lantern)) {
      AddFuel (25)
      msg ("You pour the oil into your lantern's reserve.")
      RemoveObject (oilObject)
    }
  </function>
  <function name="EndKitchen">
    msg ("The creature in the distance grunts in annoyance. You can hear his footsteps stomping closer and closer towards you. The creature rushes up towards you, and you can hear his heavy breathing, and the putrid smell of rotting meat.")
    msg ("You try to stay as silent as possible, holding your breath. The creature makes an exasperated grunt and smashes his cleaver down on the counter, bits of turkey flying everywhere. The creature makes another satisfied grunt, and walks back to where he was before.")
    msg ("You stand up, out of hiding, and see a small piece of paper sitting in the turkey rubble. You grab it and read it.")
    msg ("")
    PrintRiddle (1)
    msg ("")
    msg ("As you finish reading, a dark force overwhelms you and you pass out.")
    msg ("")
    msg ("You begin to open your eyes. You are back in the dungeon cell and your lantern is missing. 'Not this again' you groan, internally, and feel the wetness on your face again.")
    msg ("You push yourself up slowly, and see your reflection once more. You look very tired, bags under your eyes, cheeks sunken in and colourless. You rub your eyes, sigh, and stand up.")
    game.part = 1
    FaceSouth
    DisableHeart
    game.saveTime = True
    kitchen.inside = False
    lantern.parent = hub15
    lantern.fuel_level = 80
    lantern.light_level = 0
    SetHeartRate (game.defaultHeartRate)
    player.parent = dungeon7
  </function>
  <function name="LockHub">
    LockExit (West29)
    LockExit (East30)
    LockExit (North25)
    LockExit (South33)
  </function>
  <function name="WrongPiece">
    msg ("You hear the scraping of metal across the floor, and the clink of pieces of metal moving together... like a suit of armor.")
    msg ("You look to the corner of the room where the statue of the knight was. It is not there anymore.")
    msg ("You hear a clink of armor behind you, and turn around to see the knight. Shadows are oozing out of the armor.")
    msg ("The knight raises his sword high above you, and...")
    Die
  </function>
  <function name="EndLibrary">
    msg ("You aren't sure where the door leads, but you have no other choice. You frantically fumble with the knob and fling it open, scrambling through the doorway and slamming the door behind you.")
    msg ("It is dark and cool in here. Relief washes over you, and you collapse on the stone floor out of exhaustion. A familiar dark force begins to overwhelm your senses and you drift into unconsciousness.")
    msg ("In your sleep, words course through your mind. Their origin is uncertain, but to you, their meaning is clear:")
    msg ("")
    PrintRiddle (3)
    msg ("")
    msg ("You wake up.")
    msg ("By now you are familiar with the feeling of this room, and sigh. Pushing yourself up, and opening your eyes you see your reflection in that damn puddle. You look darker, and it is hard to distinguish yourself from the shadows around you. You feel hollow, and empty. You sigh again and stand up.")
    library_turn_script.enabled = false
    fire_turn_script.enabled = false
    lantern.light_level = 0
    game.part = 3
    FaceSouth
    DisableHeart
    game.saveTime = True
    SetHeartRate (game.defaultHeartRate)
    player.parent = dungeon7
  </function>
  <function name="PrintRiddle" parameters="number" type="int"><![CDATA[
    switch (number) {
      case (0) {
        msg ("<i>One against four, the battle goes on.</i>")
        msg ("<i>The one with the sword must take the pawn.</i>")
        msg ("<i>Follow the trail, of blood, sweat and tears;</i>")
        msg ("<i>For if you shall stray, youll realize your fears.</i>")
        msg ("<i>Noise is dangerous, and the darkness is loud.</i>")
        msg ("<i>To travel in it, will only for so long be allowed.</i>")
        msg ("<i>To find the exit: serve the bird,</i>")
        msg ("<i>To do so the creatures wrath must be incurred.</i>")
      }
      case (1) {
        msg ("<i>In the tower the pawn will fall.</i>")
        msg ("<i>So watch your back down the long hall.</i>")
        msg ("<i>Find the boy, time and again,</i>")
        msg ("<i>For seeking him will lead you to the end.</i>")
        msg ("<i>In a closet, it is death you will find,</i>")
        msg ("<i>If your exit is not perfectly timed.</i>")
        msg ("<i>To find the boy, listen to the nursery,</i>")
        msg ("<i>On this long night, the moons anniversary.</i>")
      }
      case (2) {
        msg ("<i>By her hand,</i>")
        msg ("<i>Her might the pawn cannot withstand.</i>")
        msg ("<i>The path is long, it forks and turns.</i>")
        msg ("<i>Be careful, because for the shadows the light burns.</i>")
        msg ("<i>There is a creature, tall and broad.</i>")
        msg ("<i>Yet, in the dark his sight is flawed.</i>")
        msg ("<i>Longer now, the darkness holds you,</i>")
        msg ("<i>But only long enough to get through.</i>")
      }
      case (3) {
        msg ("<i>Here we are, near the end.</i>")
        msg ("<i>For yourself, will you fend?</i>")
        msg ("<i>And the pawn, so mighty and strong,</i>")
        msg ("<i>Will face the darkened throng,</i>")
        msg ("<i>Only to fall at the hands of a king?</i>")
        msg ("<i>What a peculiar thing.</i>")
      }
    }
  ]]></function>
  <function name="FinishGame">
    DisableHeart
    gameover = true
    finish
  </function>
  <function name="EndNursery">
    msg ("You wake up.")
    msg ("You open your eyes. Your head is pounding, and you groan, as you push yourself up onto your hands and knees. You see your reflection in the puddle, again, and you look more tired than you can even fathom. The bags under your eyes almost seem to take up your face, and your cheeks looks shallow and sickly. You look darker, but that might just be the lack of light in the room. It almost looks like youre fading. You shake the thoughts off, and stand up.")
    msg ("You remember the piece of paper that Maven offered you before you passed out, you read it while remembering the child..")
    msg ("")
    PrintRiddle (2)
    msg ("")
    laila_turn_script.enabled = False
    nursery_turn_script.enabled = False
    game.part = 2
    FaceSouth
    DisableHeart
    game.saveTime = True
    lantern.parent = hub15
    lantern.fuel_level = 80
    lantern.light_level = 0
    SetHeartRate (game.defaultHeartRate)
    player.parent = dungeon7
  </function>
  <javascript src="javascript.js" />
</asl>